0 Spicy Spicy Spicy foreign unspecified unspecified unspecified unspecified unspecified  	I_ORG	null
1 compassion compassion compassion foreign unspecified unspecified unspecified unspecified unspecified  	I_ORG	null
2 tickling tickling tickling foreign unspecified unspecified unspecified unspecified unspecified  	I_ORG	null
3 your your your foreign unspecified unspecified unspecified unspecified unspecified  	I_ORG	null
4 anger anger anger foreign unspecified unspecified unspecified unspecified unspecified  	I_ORG	null
5 till till till foreign unspecified unspecified unspecified unspecified unspecified  	I_ORG	null
6 it it it foreign unspecified unspecified unspecified unspecified unspecified  	I_ORG	null
7 starts starts starts foreign unspecified unspecified unspecified unspecified unspecified  	I_ORG	null
8 to to to foreign unspecified unspecified unspecified unspecified unspecified  	I_ORG	null
9 melt melt melt foreign unspecified unspecified unspecified unspecified unspecified  	I_ORG	null
10 sensual sensual sensual foreign unspecified unspecified unspecified unspecified unspecified  	I_ORG	null
11 & & & punctuation unspecified unspecified unspecified unspecified unspecified  	O	null
12 funny funny funny foreign unspecified unspecified unspecified unspecified unspecified  	I_ORG	null
13 defeating defeating defeating foreign unspecified unspecified unspecified unspecified unspecified  	I_ORG	null
14 your your your foreign unspecified unspecified unspecified unspecified unspecified  	I_ORG	null
15 cynic cynic cynic foreign unspecified unspecified unspecified unspecified unspecified  	I_ORG	null
16 once once once foreign unspecified unspecified unspecified unspecified unspecified  	I_ORG	null
17 again again again foreign unspecified unspecified unspecified unspecified unspecified  	I_ORG	null
18 nectars nectars nectars foreign unspecified unspecified unspecified unspecified unspecified  	I_ORG	null
19 of of of foreign unspecified unspecified unspecified unspecified unspecified  	I_ORG	null
20 courage courage courage foreign unspecified unspecified unspecified unspecified unspecified  	I_ORG	null
21 reminding reminding reminding foreign unspecified unspecified unspecified unspecified unspecified  	I_ORG	null
22 your your your foreign unspecified unspecified unspecified unspecified unspecified  	I_ORG	null
23 heart heart heart foreign unspecified unspecified unspecified unspecified unspecified  	I_ORG	null
24 of of of foreign unspecified unspecified unspecified unspecified unspecified  	I_ORG	null
25 the the the foreign unspecified unspecified unspecified unspecified unspecified  	I_ORG	null
26 eternal eternal eternal foreign unspecified unspecified unspecified unspecified unspecified  	I_ORG	null
27 wow wow wow foreign unspecified unspecified unspecified unspecified unspecified  	I_ORG	null
28 conspiring conspiring conspiring foreign unspecified unspecified unspecified unspecified unspecified  	I_ORG	null
29 & & & punctuation unspecified unspecified unspecified unspecified unspecified  	O	null
30 present present present foreign unspecified unspecified unspecified unspecified unspecified  	I_ORG	null
31 surprising surprising surprising foreign unspecified unspecified unspecified unspecified unspecified  	I_ORG	null
32 reality reality reality foreign unspecified unspecified unspecified unspecified unspecified  	I_ORG	null
33 into into into foreign unspecified unspecified unspecified unspecified unspecified  	I_ORG	null
34 change change change foreign unspecified unspecified unspecified unspecified unspecified  	I_ORG	null
35 I I I foreign unspecified unspecified unspecified unspecified unspecified  	I_ORG	null
36 ’ ’ ’ punctuation unspecified unspecified unspecified unspecified unspecified  	O	null
37 m m m foreign unspecified unspecified unspecified unspecified unspecified  	I_ORG	null
38 singing singing singing foreign unspecified unspecified unspecified unspecified unspecified  	I_ORG	null
39 my my my foreign unspecified unspecified unspecified unspecified unspecified  	I_ORG	null
40 visa visa visa foreign unspecified unspecified unspecified unspecified unspecified  	I_ORG	null
41 to to to foreign unspecified unspecified unspecified unspecified unspecified  	I_ORG	null
42 you you you foreign unspecified unspecified unspecified unspecified unspecified  	I_ORG	null
43 so so so foreign unspecified unspecified unspecified unspecified unspecified  	I_ORG	null
44 open open open foreign unspecified unspecified unspecified unspecified unspecified  	I_ORG	null
45 your your your foreign unspecified unspecified unspecified unspecified unspecified  	I_ORG	null
46 borders borders borders foreign unspecified unspecified unspecified unspecified unspecified  	I_ORG	null
47 to to to foreign unspecified unspecified unspecified unspecified unspecified  	I_ORG	null
48 me me me foreign unspecified unspecified unspecified unspecified unspecified  	I_ORG	null
49 deja deja deja foreign unspecified unspecified unspecified unspecified unspecified  	I_ORG	null
50 ya ya ya foreign unspecified unspecified unspecified unspecified unspecified  	I_ORG	null
51 , , , punctuation unspecified unspecified unspecified unspecified unspecified  	O	null
52 ese ese ese foreign unspecified unspecified unspecified unspecified unspecified  	O	null
53 ego ego ego foreign unspecified unspecified unspecified unspecified unspecified  	O	null
54 nacional nacional nacional foreign unspecified unspecified unspecified unspecified unspecified  	O	null
55 , , , punctuation unspecified unspecified unspecified unspecified unspecified  	O	null
56 el el el foreign unspecified unspecified unspecified unspecified unspecified  	I_ORG	null
57 ego ego ego foreign unspecified unspecified unspecified unspecified unspecified  	I_ORG	null
58 religioso religioso religioso foreign unspecified unspecified unspecified unspecified unspecified  	I_ORG	null
59 y y y foreign unspecified unspecified unspecified unspecified unspecified  	I_ORG	null
60 el el el foreign unspecified unspecified unspecified unspecified unspecified  	I_ORG	null
61 ego ego ego foreign unspecified unspecified unspecified unspecified unspecified  	I_ORG	null
62 espiritual espiritual espiritual foreign unspecified unspecified unspecified unspecified unspecified  	I_ORG	null
63 llegas llegas llegas foreign unspecified unspecified unspecified unspecified unspecified  	I_ORG	null
64 a a a foreign unspecified unspecified unspecified unspecified unspecified  	I_ORG	null
65 la la la foreign unspecified unspecified unspecified unspecified unspecified  	I_ORG	null
66 nueva nueva nueva foreign unspecified unspecified unspecified unspecified unspecified  	I_ORG	null
67 frontera frontera frontera foreign unspecified unspecified unspecified unspecified unspecified  	I_ORG	null
68 y y y foreign unspecified unspecified unspecified unspecified unspecified  	I_ORG	null
69 tu tu tu foreign unspecified unspecified unspecified unspecified unspecified  	I_ORG	null
70 salvoconducto salvoconducto salvoconducto foreign unspecified unspecified unspecified unspecified unspecified  	I_ORG	null
71 sera sera sera foreign unspecified unspecified unspecified unspecified unspecified  	I_ORG	null
72 tu tu tu foreign unspecified unspecified unspecified unspecified unspecified  	I_ORG	null
73 canto canto canto foreign unspecified unspecified unspecified unspecified unspecified  	I_ORG	null
74 , , , punctuation unspecified unspecified unspecified unspecified unspecified  	O	null
75 tu tu tu foreign unspecified unspecified unspecified unspecified unspecified  	O	null
76 danza danza danza foreign unspecified unspecified unspecified unspecified unspecified  	O	null
77 original original original foreign unspecified unspecified unspecified unspecified unspecified  	O	null
78 , , , punctuation unspecified unspecified unspecified unspecified unspecified  	O	null
79 el el el foreign unspecified unspecified unspecified unspecified unspecified  	I_ORG	null
80 cuento cuento cuento foreign unspecified unspecified unspecified unspecified unspecified  	I_ORG	null
81 de de de foreign unspecified unspecified unspecified unspecified unspecified  	I_ORG	null
82 tu tu tu foreign unspecified unspecified unspecified unspecified unspecified  	I_ORG	null
83 bisabuelo bisabuelo bisabuelo foreign unspecified unspecified unspecified unspecified unspecified  	I_ORG	null
84 , , , punctuation unspecified unspecified unspecified unspecified unspecified  	O	null
85 un un un foreign unspecified unspecified unspecified unspecified unspecified  	I_ORG	null
86 chiste chiste chiste foreign unspecified unspecified unspecified unspecified unspecified  	I_ORG	null
87 carcajada carcajada carcajada foreign unspecified unspecified unspecified unspecified unspecified  	I_ORG	null
88 y y y foreign unspecified unspecified unspecified unspecified unspecified  	I_ORG	null
89 un un un foreign unspecified unspecified unspecified unspecified unspecified  	I_ORG	null
90 arrorro arrorro arrorro foreign unspecified unspecified unspecified unspecified unspecified  	I_ORG	null
91 prenatal prenatal prenatal foreign unspecified unspecified unspecified unspecified unspecified  	I_ORG	null
92 te te te foreign unspecified unspecified unspecified unspecified unspecified  	I_ORG	null
93 reciben reciben reciben foreign unspecified unspecified unspecified unspecified unspecified  	I_ORG	null
94 oficialmente oficialmente oficialmente foreign unspecified unspecified unspecified unspecified unspecified  	I_ORG	null
95 con con con foreign unspecified unspecified unspecified unspecified unspecified  	I_ORG	null
96 elojios elojios elojios foreign unspecified unspecified unspecified unspecified unspecified  	I_ORG	null
97 y y y foreign unspecified unspecified unspecified unspecified unspecified  	I_ORG	null
98 abrazos abrazos abrazos foreign unspecified unspecified unspecified unspecified unspecified  	I_ORG	null
99 , , , punctuation unspecified unspecified unspecified unspecified unspecified  	O	null
100 hierbas hierbas hierbas foreign unspecified unspecified unspecified unspecified unspecified  	I_ORG	null
101 autoctonas autoctonas autoctonas foreign unspecified unspecified unspecified unspecified unspecified  	I_ORG	null
102 con con con foreign unspecified unspecified unspecified unspecified unspecified  	I_ORG	null
103 gusto gusto gusto foreign unspecified unspecified unspecified unspecified unspecified  	I_ORG	null
104 a a a foreign unspecified unspecified unspecified unspecified unspecified  	I_ORG	null
105 miel miel miel foreign unspecified unspecified unspecified unspecified unspecified  	I_ORG	null
106 , , , punctuation unspecified unspecified unspecified unspecified unspecified  	O	null
107 un un un foreign unspecified unspecified unspecified unspecified unspecified  	I_ORG	null
108 bano bano bano foreign unspecified unspecified unspecified unspecified unspecified  	I_ORG	null
109 hirviendo hirviendo hirviendo foreign unspecified unspecified unspecified unspecified unspecified  	I_ORG	null
110 y y y foreign unspecified unspecified unspecified unspecified unspecified  	I_ORG	null
111 masajes masajes masajes foreign unspecified unspecified unspecified unspecified unspecified  	I_ORG	null
112 agazajando agazajando agazajando foreign unspecified unspecified unspecified unspecified unspecified  	I_ORG	null
113 a a a foreign unspecified unspecified unspecified unspecified unspecified  	I_ORG	null
114 tu tu tu foreign unspecified unspecified unspecified unspecified unspecified  	I_ORG	null
115 piel piel piel foreign unspecified unspecified unspecified unspecified unspecified  	I_ORG	null
116 brebajes brebajes brebajes foreign unspecified unspecified unspecified unspecified unspecified  	I_ORG	null
117 del del del foreign unspecified unspecified unspecified unspecified unspecified  	I_ORG	null
118 espiritu espiritu espiritu foreign unspecified unspecified unspecified unspecified unspecified  	I_ORG	null
119 , , , punctuation unspecified unspecified unspecified unspecified unspecified  	O	null
120 cantos cantos cantos foreign unspecified unspecified unspecified unspecified unspecified  	I_ORG	null
121 antiguos antiguos antiguos foreign unspecified unspecified unspecified unspecified unspecified  	I_ORG	null
122 en en en foreign unspecified unspecified unspecified unspecified unspecified  	I_ORG	null
123 el el el foreign unspecified unspecified unspecified unspecified unspecified  	I_ORG	null
124 idioma idioma idioma foreign unspecified unspecified unspecified unspecified unspecified  	I_ORG	null
125 local local local foreign unspecified unspecified unspecified unspecified unspecified  	I_ORG	null
126 I I I foreign unspecified unspecified unspecified unspecified unspecified  	I_ORG	null
127 ’ ’ ’ punctuation unspecified unspecified unspecified unspecified unspecified  	O	null
128 m m m foreign unspecified unspecified unspecified unspecified unspecified  	I_ORG	null
129 dancing dancing dancing foreign unspecified unspecified unspecified unspecified unspecified  	I_ORG	null
130 my my my foreign unspecified unspecified unspecified unspecified unspecified  	I_ORG	null
131 visa visa visa foreign unspecified unspecified unspecified unspecified unspecified  	I_ORG	null
132 to to to foreign unspecified unspecified unspecified unspecified unspecified  	I_ORG	null
133 you you you foreign unspecified unspecified unspecified unspecified unspecified  	I_ORG	null
134 so so so foreign unspecified unspecified unspecified unspecified unspecified  	I_ORG	null
135 open open open foreign unspecified unspecified unspecified unspecified unspecified  	I_ORG	null
136 your your your foreign unspecified unspecified unspecified unspecified unspecified  	I_ORG	null
137 borders borders borders foreign unspecified unspecified unspecified unspecified unspecified  	I_ORG	null
138 to to to foreign unspecified unspecified unspecified unspecified unspecified  	I_ORG	null
139 me me me foreign unspecified unspecified unspecified unspecified unspecified  	I_ORG	null
140 tremors tremors tremors foreign unspecified unspecified unspecified unspecified unspecified  	I_ORG	null
141 of of of foreign unspecified unspecified unspecified unspecified unspecified  	I_ORG	null
142 wisdom wisdom wisdom foreign unspecified unspecified unspecified unspecified unspecified  	I_ORG	null
143 sailing sailing sailing foreign unspecified unspecified unspecified unspecified unspecified  	I_ORG	null
144 through through through foreign unspecified unspecified unspecified unspecified unspecified  	I_ORG	null
145 your your your foreign unspecified unspecified unspecified unspecified unspecified  	I_ORG	null
146 spine spine spine foreign unspecified unspecified unspecified unspecified unspecified  	I_ORG	null
147 until until until foreign unspecified unspecified unspecified unspecified unspecified  	I_ORG	null
148 you’re you’re you’re foreign unspecified unspecified unspecified unspecified unspecified  	I_ORG	null
149 wide wide wide foreign unspecified unspecified unspecified unspecified unspecified  	I_ORG	null
150 awake awake awake foreign unspecified unspecified unspecified unspecified unspecified  	I_ORG	null
151 worries worries worries foreign unspecified unspecified unspecified unspecified unspecified  	I_ORG	null
152 & & & punctuation unspecified unspecified unspecified unspecified unspecified  	O	null
153 monsters monsters monsters foreign unspecified unspecified unspecified unspecified unspecified  	I_ORG	null
154 evaporating evaporating evaporating foreign unspecified unspecified unspecified unspecified unspecified  	I_ORG	null
155 from from from foreign unspecified unspecified unspecified unspecified unspecified  	I_ORG	null
156 your your your foreign unspecified unspecified unspecified unspecified unspecified  	I_ORG	null
157 brain brain brain foreign unspecified unspecified unspecified unspecified unspecified  	I_ORG	null
158 shining shining shining foreign unspecified unspecified unspecified unspecified unspecified  	I_ORG	null
159 your your your foreign unspecified unspecified unspecified unspecified unspecified  	I_ORG	null
160 essence essence essence foreign unspecified unspecified unspecified unspecified unspecified  	I_ORG	null
161 stretching stretching stretching foreign unspecified unspecified unspecified unspecified unspecified  	I_ORG	null
162 identity identity identity foreign unspecified unspecified unspecified unspecified unspecified  	I_ORG	null
163 in in in foreign unspecified unspecified unspecified unspecified unspecified  	I_ORG	null
164 so so so foreign unspecified unspecified unspecified unspecified unspecified  	I_ORG	null
165 many many many foreign unspecified unspecified unspecified unspecified unspecified  	I_ORG	null
166 ways ways ways foreign unspecified unspecified unspecified unspecified unspecified  	I_ORG	null
167 grammar grammar grammar foreign unspecified unspecified unspecified unspecified unspecified  	I_ORG	null
168 & & & punctuation unspecified unspecified unspecified unspecified unspecified  	O	null
169 passports passports passports foreign unspecified unspecified unspecified unspecified unspecified  	I_ORG	null
170 disappearing disappearing disappearing foreign unspecified unspecified unspecified unspecified unspecified  	I_ORG	null
171 from from from foreign unspecified unspecified unspecified unspecified unspecified  	I_ORG	null
172 the the the foreign unspecified unspecified unspecified unspecified unspecified  	I_ORG	null
173 frame frame frame foreign unspecified unspecified unspecified unspecified unspecified  	I_ORG	null

