0 זה זה זה pronoun masculine singular unspecified 3 unspecified  	O	null
1 לא לא לא negation unspecified unspecified unspecified unspecified unspecified  	O	null
2 נורמאלי נורמלי נורמאלי adjective masculine singular absolute unspecified unspecified  	O	null
3 , , , punctuation unspecified unspecified unspecified unspecified unspecified  	O	null
4 רק רק רק conjunction unspecified unspecified unspecified unspecified unspecified  	O	null
5 טעמתי טעם טעמתי verb masculine-and-feminine singular unspecified 1 past  	O	null
6 אני הוא אני pronoun masculine-and-feminine singular unspecified 1 unspecified  	O	null
7 חושב חשב חושב verb masculine singular unspecified any beinoni  	O	null
8 ש ש שזה relativizer/subordinatingConjunction unspecified unspecified unspecified unspecified unspecified 0 
8 זה זה שזה pronoun masculine singular unspecified 3 unspecified  	O	null
9 גדול גדול גדול adjective masculine singular absolute unspecified unspecified  	O	null
10 הם הוא הם pronoun masculine plural unspecified 3 unspecified  	O	null
11 לא לא לא negation unspecified unspecified unspecified unspecified unspecified  	O	null
12 נתנו נתן נתנו verb masculine-and-feminine plural unspecified 3 past  	O	null
13 ל ל לי preposition unspecified unspecified unspecified unspecified unspecified  
13 י י לי pronomial masculine-and-feminine singular unspecified 1 unspecified 0 	O	null
14 כי כי כי conjunction unspecified unspecified unspecified unspecified unspecified  	O	null
15 לא לא לא negation unspecified unspecified unspecified unspecified unspecified  	O	null
16 לקחתי לקח לקחתי verb masculine-and-feminine singular unspecified 1 past  	O	null
17 , , , punctuation unspecified unspecified unspecified unspecified unspecified  	O	null
18 הם הוא הם pronoun masculine plural unspecified 3 unspecified  	O	null
19 טוענים טען טוענים verb masculine plural unspecified any beinoni  	O	null
20 ש ש שזה relativizer/subordinatingConjunction unspecified unspecified unspecified unspecified unspecified 0 
20 זה זה שזה pronoun masculine singular unspecified 3 unspecified  	O	null
21 בזול בזול בזול adverb unspecified unspecified unspecified unspecified unspecified  	O	null
22 , , , punctuation unspecified unspecified unspecified unspecified unspecified  	O	null
23 פנטסטי פנטסטי פנטסטי adjective masculine singular absolute unspecified unspecified  	O	null
24 ! ! ! punctuation unspecified unspecified unspecified unspecified unspecified  	O	null

0 זה זה זה pronoun masculine singular unspecified 3 unspecified  	O	null
1 יגיע הגיע יגיע verb masculine singular unspecified 3 future  	O	null
2 ב ב בשש preposition unspecified unspecified unspecified unspecified unspecified 0 
2 שש שש בשש noun masculine singular absolute unspecified unspecified  	O	null
3 לפני לפני לפני preposition unspecified unspecified unspecified unspecified unspecified  	O	null
4 ה ה השקיעה definiteArticle unspecified unspecified unspecified unspecified unspecified 0 
4 השקיעה שקיעה השקיעה noun feminine singular absolute unspecified unspecified  	O	null
5 חומר חומר חומר noun masculine singular absolute unspecified unspecified  	O	null
6 ל ל למחשבה preposition unspecified unspecified unspecified unspecified unspecified 0 
6 ה ה למחשבה definiteArticle unspecified unspecified unspecified unspecified unspecified 0 
6 המחשבה מחשבה למחשבה noun feminine singular absolute unspecified unspecified  	O	null
7 , , , punctuation unspecified unspecified unspecified unspecified unspecified  	O	null
8 בינתיים בינתיים בינתיים adverb unspecified unspecified unspecified unspecified unspecified  	O	null
9 נדבר נדבר נדבר verb masculine singular unspecified 3 past  	O	null
10 ב ב בשפה preposition unspecified unspecified unspecified unspecified unspecified 0 
10 שפה שפה בשפה noun feminine singular absolute unspecified unspecified  	O	null
11 גבוהה גבוה גבוהה adjective feminine singular absolute unspecified unspecified  	O	null
12 הא הא הא properName unspecified unspecified unspecified unspecified unspecified  	I_LOC	null
13 - - - punctuation unspecified unspecified unspecified unspecified unspecified  	O	null
14 צדי צדי צדי properName unspecified unspecified unspecified unspecified unspecified  	I_LOC	null
15 - - - properName unspecified unspecified unspecified unspecified unspecified  	I_LOC	null
16 יוד יוד יוד properName unspecified unspecified unspecified unspecified unspecified  	I_LOC	null
17 - - - punctuation unspecified unspecified unspecified unspecified unspecified  	O	null
18 ל ל למד preposition unspecified unspecified unspecified unspecified unspecified 0 
18 מד מד למד noun masculine singular construct unspecified unspecified  	O	null
19 - - - punctuation unspecified unspecified unspecified unspecified unspecified  	O	null
20 וו וו וו properName feminine singular unspecified unspecified unspecified  	I_ORG	null

0 תראו ראה תראו verb masculine-and-feminine plural unspecified 2 future  	O	null
1 ! ! ! punctuation unspecified unspecified unspecified unspecified unspecified  	O	null

0 עב"ם עב"ם עב"ם properName unspecified unspecified unspecified unspecified unspecified  	I_PERS	null
1 ! ! ! punctuation unspecified unspecified unspecified unspecified unspecified  	O	null

0 ל ל לפחד preposition unspecified unspecified unspecified unspecified unspecified 0 
0 פחד פחד לפחד noun masculine singular absolute unspecified unspecified  	O	null
1 לנחות נחת לנחות verb unspecified unspecified unspecified unspecified infinitive  	O	null
2 זה זה זה pronoun masculine singular unspecified 3 unspecified  	O	null
3 סימן סימן סימן noun masculine singular absolute unspecified unspecified  	O	null
4 ש ש שאני relativizer/subordinatingConjunction unspecified unspecified unspecified unspecified unspecified 0 
4 אני הוא שאני pronoun masculine-and-feminine singular unspecified 1 unspecified  	O	null
5 עף עף עף verb masculine singular unspecified any beinoni  	O	null
6 . . . punctuation unspecified unspecified unspecified unspecified unspecified  	O	null

0 ה ה הסלון definiteArticle unspecified unspecified unspecified unspecified unspecified 0 
0 הסלון סלון הסלון noun masculine singular absolute unspecified unspecified  	O	null
1 נראה נראה נראה verb masculine singular unspecified 3 past  	O	null
2 מצוין מצוין מצוין adjective masculine singular absolute unspecified unspecified  	O	null
3 ו ו וזה conjunction unspecified unspecified unspecified unspecified unspecified 0 
3 זה זה וזה pronoun masculine singular unspecified 3 unspecified  	O	null
4 יפה יפה יפה adverb unspecified unspecified unspecified unspecified unspecified  	O	null
5 ש ש שהפסקת relativizer/subordinatingConjunction unspecified unspecified unspecified unspecified unspecified 0 
5 הפסקת הפסקה שהפסקת noun feminine singular construct unspecified unspecified  	O	null
6 לדפוק דפק לדפוק verb unspecified unspecified unspecified unspecified infinitive  	O	null
7 מ מ מהצד preposition unspecified unspecified unspecified unspecified unspecified 0 
7 ה ה מהצד definiteArticle unspecified unspecified unspecified unspecified unspecified 0 
7 הצד צד מהצד noun masculine singular absolute unspecified unspecified  	O	null
8 ו ו ושהחלטת conjunction unspecified unspecified unspecified unspecified unspecified 0 
8 ש ש ושהחלטת relativizer/subordinatingConjunction unspecified unspecified unspecified unspecified unspecified 0 
8 החלטת החלטה ושהחלטת noun feminine singular construct unspecified unspecified  	O	null
9 להחזיק החזיק להחזיק verb unspecified unspecified unspecified unspecified infinitive  	O	null
10 מעמד מעמד מעמד noun masculine singular absolute unspecified unspecified  	O	null
11 מש מש מש verb masculine singular unspecified 3 past  	O	null
12 נחמד נחמד נחמד adjective masculine singular absolute unspecified unspecified  	O	null
13 , , , punctuation unspecified unspecified unspecified unspecified unspecified  	O	null
14 מרשים.. מרשים.. מרשים.. properName unspecified unspecified unspecified unspecified unspecified  	I_PERS	null
15 אם אם אם conjunction unspecified unspecified unspecified unspecified unspecified  	O	null
16 יש יש יש existential unspecified unspecified unspecified unspecified unspecified  	O	null
17 אלוהים.. אלוהים.. אלוהים.. verb masculine singular unspecified 2 imperative  	O	null
18 זה זה זה pronoun masculine singular unspecified 3 unspecified  	O	null
19 יגיע הגיע יגיע verb masculine singular unspecified 3 future  	O	null
20 ב ב בשש preposition unspecified unspecified unspecified unspecified unspecified 0 
20 שש שש בשש noun masculine singular absolute unspecified unspecified  	O	null
21 לפני לפני לפני preposition unspecified unspecified unspecified unspecified unspecified  	O	null
22 ה ה השקיעה definiteArticle unspecified unspecified unspecified unspecified unspecified 0 
22 השקיעה שקיעה השקיעה noun feminine singular absolute unspecified unspecified  	O	null
23 חומר חומר חומר noun masculine singular absolute unspecified unspecified  	O	null
24 ל ל למחשבה preposition unspecified unspecified unspecified unspecified unspecified 0 
24 ה ה למחשבה definiteArticle unspecified unspecified unspecified unspecified unspecified 0 
24 המחשבה מחשבה למחשבה noun feminine singular absolute unspecified unspecified  	O	null
25 , , , punctuation unspecified unspecified unspecified unspecified unspecified  	O	null
26 בינתיים בינתיים בינתיים adverb unspecified unspecified unspecified unspecified unspecified  	O	null
27 נדבר נדבר נדבר verb masculine singular unspecified 3 past  	O	null
28 ב ב בשפה preposition unspecified unspecified unspecified unspecified unspecified 0 
28 שפה שפה בשפה noun feminine singular absolute unspecified unspecified  	O	null
29 גבוהה גבוה גבוהה adjective feminine singular absolute unspecified unspecified  	O	null
30 הא הא הא properName unspecified unspecified unspecified unspecified unspecified  	I_LOC	null
31 - - - punctuation unspecified unspecified unspecified unspecified unspecified  	O	null
32 צדי צדי צדי properName unspecified unspecified unspecified unspecified unspecified  	I_LOC	null
33 - - - properName unspecified unspecified unspecified unspecified unspecified  	I_LOC	null
34 יוד יוד יוד properName unspecified unspecified unspecified unspecified unspecified  	I_LOC	null
35 - - - punctuation unspecified unspecified unspecified unspecified unspecified  	O	null
36 למד למד למד verb masculine singular unspecified 3 past  	O	null
37 - - - punctuation unspecified unspecified unspecified unspecified unspecified  	O	null
38 וו וו וו noun masculine singular absolute unspecified unspecified  	O	null

0 תראו ראה תראו verb masculine-and-feminine plural unspecified 2 future  	O	null
1 ! ! ! punctuation unspecified unspecified unspecified unspecified unspecified  	O	null

0 עב"ם עב"ם עב"ם properName unspecified unspecified unspecified unspecified unspecified  	I_PERS	null
1 ! ! ! punctuation unspecified unspecified unspecified unspecified unspecified  	O	null

0 ל ל לפחד preposition unspecified unspecified unspecified unspecified unspecified 0 
0 פחד פחד לפחד noun masculine singular absolute unspecified unspecified  	O	null
1 לנחות נחת לנחות verb unspecified unspecified unspecified unspecified infinitive  	O	null
2 זה זה זה pronoun masculine singular unspecified 3 unspecified  	O	null
3 סימן סימן סימן noun masculine singular absolute unspecified unspecified  	O	null
4 ש ש שאני relativizer/subordinatingConjunction unspecified unspecified unspecified unspecified unspecified 0 
4 אני הוא שאני pronoun masculine-and-feminine singular unspecified 1 unspecified  	O	null
5 עף עף עף verb masculine singular unspecified any beinoni  	O	null
6 . . . punctuation unspecified unspecified unspecified unspecified unspecified  	O	null

0 זה זה זה pronoun masculine singular unspecified 3 unspecified  	O	null
1 לא לא לא negation unspecified unspecified unspecified unspecified unspecified  	O	null
2 נורמאלי נורמלי נורמאלי adjective masculine singular absolute unspecified unspecified  	O	null
3 , , , punctuation unspecified unspecified unspecified unspecified unspecified  	O	null
4 רק רק רק conjunction unspecified unspecified unspecified unspecified unspecified  	O	null
5 טעמתי טעם טעמתי verb masculine-and-feminine singular unspecified 1 past  	O	null
6 אני הוא אני pronoun masculine-and-feminine singular unspecified 1 unspecified  	O	null
7 חושב חשב חושב verb masculine singular unspecified any beinoni  	O	null
8 ש ש שאני relativizer/subordinatingConjunction unspecified unspecified unspecified unspecified unspecified 0 
8 אני אני שאני noun masculine singular absolute unspecified unspecified  	O	null
9 גדול.. גדול.. גדול.. adjective feminine plural absolute unspecified unspecified  	O	null

0 חומרים חומר חומרים noun masculine plural absolute unspecified unspecified  	O	null
1 מתרוצצים התרוצץ מתרוצצים verb masculine plural unspecified any beinoni  	O	null
2 ב ב בבניין preposition unspecified unspecified unspecified unspecified unspecified 0 
2 ה ה בבניין definiteArticle unspecified unspecified unspecified unspecified unspecified 0 
2 הבניין בניין בבניין noun masculine singular absolute unspecified unspecified  	O	null
3 להעביר העביר להעביר verb unspecified unspecified unspecified unspecified infinitive  	O	null
4 את את את at-preposition unspecified unspecified unspecified unspecified unspecified  	O	null
5 ה ה הזמן definiteArticle unspecified unspecified unspecified unspecified unspecified 0 
5 הזמן זמן הזמן noun masculine singular absolute unspecified unspecified  	O	null
6 ה ה הקטן definiteArticle unspecified unspecified unspecified unspecified unspecified 0 
6 הקטן קטן הקטן adjective masculine singular absolute unspecified unspecified  	O	null
7 ב ב בשיחות preposition unspecified unspecified unspecified unspecified unspecified 0 
7 שיחות שיחה בשיחות noun feminine plural construct unspecified unspecified  	O	null
8 סילון סילון סילון noun masculine singular absolute unspecified unspecified  	O	null
9 , , , punctuation unspecified unspecified unspecified unspecified unspecified  	O	null
10 ב ב בזמן preposition unspecified unspecified unspecified unspecified unspecified 0 
10 זמן זמן בזמן noun masculine singular construct unspecified unspecified  	O	null
11 הנכון.. הנכון.. הנכון.. noun masculine-and-feminine singular absolute unspecified unspecified  	O	null
12 זה זה זה pronoun masculine singular unspecified 3 unspecified  	O	null
13 יגיע הגיע יגיע verb masculine singular unspecified 3 future  	O	null
14 ב ב בשש preposition unspecified unspecified unspecified unspecified unspecified 0 
14 שש שש בשש noun masculine singular construct unspecified unspecified  	O	null
15 בול בול בול noun masculine singular absolute unspecified unspecified  	O	null
16 ב ב בשקיעה preposition unspecified unspecified unspecified unspecified unspecified 0 
16 שקיעה שקיעה בשקיעה noun feminine singular absolute unspecified unspecified  	O	null
17 חומר חומר חומר noun masculine singular absolute unspecified unspecified  	O	null
18 ל ל למחשבה preposition unspecified unspecified unspecified unspecified unspecified 0 
18 ה ה למחשבה definiteArticle unspecified unspecified unspecified unspecified unspecified 0 
18 המחשבה מחשבה למחשבה noun feminine singular absolute unspecified unspecified  	O	null
19 , , , punctuation unspecified unspecified unspecified unspecified unspecified  	O	null
20 בינתיים בינתיים בינתיים adverb unspecified unspecified unspecified unspecified unspecified  	O	null
21 נדבר נדבר נדבר verb masculine singular unspecified 3 past  	O	null
22 ב ב בשפה preposition unspecified unspecified unspecified unspecified unspecified 0 
22 שפה שפה בשפה noun feminine singular absolute unspecified unspecified  	O	null
23 גבוהה גבוה גבוהה adjective feminine singular absolute unspecified unspecified  	O	null
24 הא הא הא properName unspecified unspecified unspecified unspecified unspecified  	I_LOC	null
25 - - - punctuation unspecified unspecified unspecified unspecified unspecified  	O	null
26 צדי צדי צדי properName unspecified unspecified unspecified unspecified unspecified  	I_LOC	null
27 - - - properName unspecified unspecified unspecified unspecified unspecified  	I_LOC	null
28 יוד יוד יוד properName unspecified unspecified unspecified unspecified unspecified  	I_LOC	null
29 - - - punctuation unspecified unspecified unspecified unspecified unspecified  	O	null
30 ל ל למד preposition unspecified unspecified unspecified unspecified unspecified 0 
30 מד מד למד noun masculine singular construct unspecified unspecified  	O	null
31 - - - punctuation unspecified unspecified unspecified unspecified unspecified  	O	null
32 וו וו וו noun masculine singular absolute unspecified unspecified  	O	null

