0 אני הוא אני pronoun masculine-and-feminine singular unspecified 1 unspecified  	O	null
1 אוהב אהב אוהב verb masculine singular unspecified any beinoni  	O	null
2 את את אותך at-preposition unspecified unspecified unspecified unspecified unspecified  
2 ך ך אותך pronomial masculine singular unspecified 2 unspecified 0 	O	null
3 בית"ר בית"ר בית"ר properName unspecified unspecified unspecified unspecified unspecified  	I_ORG	null
4 אני אני אני noun masculine singular absolute unspecified unspecified  	O	null
5 אוהב אהב אוהב verb masculine singular unspecified any beinoni  	O	null
6 את את אותך at-preposition unspecified unspecified unspecified unspecified unspecified  
6 ך ך אותך pronomial masculine singular unspecified 2 unspecified 0 	O	null
7 בית"ר בית"ר בית"ר properName unspecified unspecified unspecified unspecified unspecified  	I_ORG	null
8 אני אני אני noun masculine singular absolute unspecified unspecified  	O	null
9 אוהב אהב אוהב verb masculine singular unspecified any beinoni  	O	null
10 את את אותך at-preposition unspecified unspecified unspecified unspecified unspecified  
10 ך ך אותך pronomial masculine singular unspecified 2 unspecified 0 	O	null
11 בית"ר בית"ר בית"ר properName unspecified unspecified unspecified unspecified unspecified  	I_ORG	null
12 ירושלים ירושלים ירושלים properName unspecified unspecified unspecified unspecified unspecified  	I_ORG	null

0 עולים עולה עולים noun masculine plural absolute unspecified unspecified  	O	null
1 על על על preposition unspecified unspecified unspecified unspecified unspecified  	O	null
2 ה ה המגרש definiteArticle unspecified unspecified unspecified unspecified unspecified 0 
2 המגרש מגרש המגרש noun masculine singular absolute unspecified unspecified  	O	null
3 נותנים נתן נותנים verb masculine plural unspecified any beinoni  	O	null
4 פה פה פה adverb unspecified unspecified unspecified unspecified unspecified  	O	null
5 הצגה הצגה הצגה noun feminine singular absolute unspecified unspecified  	O	null
6 ה ה הצהובים definiteArticle unspecified unspecified unspecified unspecified unspecified 0 
6 הצהובים צהוב הצהובים adjective masculine plural absolute unspecified unspecified  	O	null
7 באים בא באים verb masculine plural unspecified any beinoni  	O	null
8 משחקים משחק משחקים noun masculine plural absolute unspecified unspecified  	O	null
9 כמו כמו כמו preposition unspecified unspecified unspecified unspecified unspecified  	O	null
10 אלופים אלוף אלופים noun masculine plural absolute unspecified unspecified  	O	null

0 תרגיל תרגיל תרגיל noun masculine singular absolute unspecified unspecified  	O	null
1 ועוד ועוד ועוד conjunction unspecified unspecified unspecified unspecified unspecified  	O	null
2 תרגיל תרגיל תרגיל noun masculine singular absolute unspecified unspecified  	O	null
3 עוד עוד עוד adverb unspecified unspecified unspecified unspecified unspecified  	O	null
4 גול גול גול noun masculine singular absolute unspecified unspecified  	O	null
5 כאן כאן כאן adverb unspecified unspecified unspecified unspecified unspecified  	O	null
6 מכניסים הכניס מכניסים verb masculine plural unspecified any beinoni  	O	null
7 ה ה האוהדים definiteArticle unspecified unspecified unspecified unspecified unspecified 0 
7 האוהדים אוהד האוהדים noun masculine plural absolute unspecified unspecified  	O	null
8 רוצים רצה רוצים verb masculine plural unspecified any beinoni  	O	null
9 עוד עוד עוד adverb unspecified unspecified unspecified unspecified unspecified  	O	null
10 ניצחון ניצחון ניצחון noun masculine singular absolute unspecified unspecified  	O	null
11 ל ל לבית preposition unspecified unspecified unspecified unspecified unspecified 0 
11 בית בית לבית noun masculine singular construct unspecified unspecified  	O	null
12 " " " punctuation unspecified unspecified unspecified unspecified unspecified  	O	null
13 רים רים רים noun masculine singular absolute unspecified unspecified  	O	null

0 אני הוא אני pronoun masculine-and-feminine singular unspecified 1 unspecified  	O	null
1 אוהב אהב אוהב verb masculine singular unspecified any beinoni  	O	null
2 את את אותך at-preposition unspecified unspecified unspecified unspecified unspecified  
2 ך ך אותך pronomial masculine singular unspecified 2 unspecified 0 	O	null
3 בית"ר בית"ר בית"ר properName unspecified unspecified unspecified unspecified unspecified  	I_ORG	null
4 אני אני אני noun masculine singular absolute unspecified unspecified  	O	null
5 אוהב אהב אוהב verb masculine singular unspecified any beinoni  	O	null
6 את את אותך at-preposition unspecified unspecified unspecified unspecified unspecified  
6 ך ך אותך pronomial masculine singular unspecified 2 unspecified 0 	O	null
7 בית"ר בית"ר בית"ר properName unspecified unspecified unspecified unspecified unspecified  	I_ORG	null
8 אני אני אני noun masculine singular absolute unspecified unspecified  	O	null
9 אוהב אהב אוהב verb masculine singular unspecified any beinoni  	O	null
10 את את אותך at-preposition unspecified unspecified unspecified unspecified unspecified  
10 ך ך אותך pronomial masculine singular unspecified 2 unspecified 0 	O	null
11 בית"ר בית"ר בית"ר properName unspecified unspecified unspecified unspecified unspecified  	I_ORG	null
12 ירושלים ירושלים ירושלים properName unspecified unspecified unspecified unspecified unspecified  	I_ORG	null
13 אני אני אני noun masculine singular absolute unspecified unspecified  	O	null
14 אוהב אהב אוהב verb masculine singular unspecified any beinoni  	O	null
15 את את אותך at-preposition unspecified unspecified unspecified unspecified unspecified  
15 ך ך אותך pronomial masculine singular unspecified 2 unspecified 0 	O	null
16 בית"ר בית"ר בית"ר properName unspecified unspecified unspecified unspecified unspecified  	I_ORG	null
17 אני אני אני noun masculine singular absolute unspecified unspecified  	O	null
18 אוהב אהב אוהב verb masculine singular unspecified any beinoni  	O	null
19 את את אותך at-preposition unspecified unspecified unspecified unspecified unspecified  
19 ך ך אותך pronomial masculine singular unspecified 2 unspecified 0 	O	null
20 בית"ר בית"ר בית"ר properName unspecified unspecified unspecified unspecified unspecified  	I_ORG	null
21 אני אני אני noun masculine singular absolute unspecified unspecified  	O	null
22 אוהב אהב אוהב verb masculine singular unspecified any beinoni  	O	null
23 את את אותך at-preposition unspecified unspecified unspecified unspecified unspecified  
23 ך ך אותך pronomial masculine singular unspecified 2 unspecified 0 	O	null
24 בית"ר בית"ר בית"ר properName unspecified unspecified unspecified unspecified unspecified  	I_ORG	null
25 עד עד עד preposition unspecified unspecified unspecified unspecified unspecified  	O	null
26 ה ה השמיים definiteArticle unspecified unspecified unspecified unspecified unspecified 0 
26 השמיים שמיים השמיים noun masculine plural absolute unspecified unspecified  	O	null

0 את את את at-preposition unspecified unspecified unspecified unspecified unspecified  	O	null
1 ה ה הנשמה definiteArticle unspecified unspecified unspecified unspecified unspecified 0 
1 הנשמה נשמה הנשמה noun feminine singular absolute unspecified unspecified  	O	null
2 נותנים נתן נותנים verb masculine plural unspecified any beinoni  	O	null
3 כאן כאן כאן adverb unspecified unspecified unspecified unspecified unspecified  	O	null
4 לא לא לא negation unspecified unspecified unspecified unspecified unspecified  	O	null
5 מוותרים ויתר מוותרים verb masculine plural unspecified any beinoni  	O	null
6 הר הר הר properName unspecified unspecified unspecified unspecified unspecified  	I_LOC	null
7 ה ה הגעש definiteArticle unspecified unspecified unspecified unspecified unspecified 0 
7 הגעש געש הגעש noun masculine singular absolute unspecified unspecified  	O	null
8 כאן כאן כאן adverb unspecified unspecified unspecified unspecified unspecified  	O	null
9 גול גול גול noun masculine singular absolute unspecified unspecified  	O	null
10 איזה איזה איזה quantifier unspecified unspecified construct unspecified unspecified  	O	null
11 חגיגה חגיגה חגיגה noun feminine singular absolute unspecified unspecified  	O	null
12 ל ל לגיהנום preposition unspecified unspecified unspecified unspecified unspecified 0 
12 ה ה לגיהנום definiteArticle unspecified unspecified unspecified unspecified unspecified 0 
12 הגיהנום גיהינום לגיהנום noun masculine-and-feminine singular absolute unspecified unspecified  	O	null
13 באים בא באים verb masculine plural unspecified any beinoni  	O	null
14 כולם כולם כולם pronoun masculine plural unspecified 3 unspecified  	O	null
15 כאן כאן כאן adverb unspecified unspecified unspecified unspecified unspecified  	O	null
16 מפסידים הפסיד מפסידים verb masculine plural unspecified any beinoni  	O	null
17 ה ה הבית definiteArticle unspecified unspecified unspecified unspecified unspecified 0 
17 הבית בית הבית noun masculine singular absolute unspecified unspecified  	O	null
18 " " " punctuation unspecified unspecified unspecified unspecified unspecified  	O	null
19 רים רים רים properName unspecified unspecified unspecified unspecified unspecified  	I_ORG	null
20 באים בא באים verb masculine plural unspecified any beinoni  	O	null
21 עוד עוד עוד adverb unspecified unspecified unspecified unspecified unspecified  	O	null
22 ניצחון ניצחון ניצחון noun masculine singular absolute unspecified unspecified  	O	null
23 ל ל לצהובים preposition unspecified unspecified unspecified unspecified unspecified 0 
23 צהובים צהוב לצהובים adjective masculine plural absolute unspecified unspecified  	O	null

0 אני הוא אני pronoun masculine-and-feminine singular unspecified 1 unspecified  	O	null
1 אוהב אהב אוהב verb masculine singular unspecified any beinoni  	O	null
2 את את אותך at-preposition unspecified unspecified unspecified unspecified unspecified  
2 ך ך אותך pronomial masculine singular unspecified 2 unspecified 0 	O	null
3 בית בית בית noun masculine singular absolute unspecified unspecified  	O	null
4 " " " punctuation unspecified unspecified unspecified unspecified unspecified  	O	null
5 ר... ר... ר... properName unspecified unspecified unspecified unspecified unspecified  	I_ORG	null

