0 כ כ ככוכב preposition unspecified unspecified unspecified unspecified unspecified 0 
0 כוכב כוכב ככוכב noun masculine singular construct unspecified unspecified  	O	null
1 אתור תר אתור verb masculine-and-feminine singular unspecified 1 future  	O	null
2 ו ו ואתעה conjunction unspecified unspecified unspecified unspecified unspecified 0 
2 אתעה תעה ואתעה verb masculine-and-feminine singular unspecified 1 future  	O	null
3 ב ב בדד preposition unspecified unspecified unspecified unspecified unspecified 0 
3 דד דד בדד noun masculine singular construct unspecified unspecified  	O	null
4 גמלי גמל גמלי noun masculine plural construct unspecified unspecified  	O	null
5 ישק ישק ישק properName unspecified unspecified unspecified unspecified unspecified  	O	null
6 אפקי אפקי אפקים noun masculine singular absolute unspecified unspecified  
6 ו ו אפקים possessive masculine singular unspecified 3 unspecified 0 	O	null
7 דמדומים דמדום דמדומים noun masculine plural absolute unspecified unspecified  	O	null
8 ילהבו להב ילהבו verb masculine-and-feminine plural unspecified 3 future  	O	null
9 ב ב בשמי preposition unspecified unspecified unspecified unspecified unspecified 0 
9 שמי שמיים בשמי noun masculine plural construct unspecified unspecified  	O	null
10 - - - punctuation unspecified unspecified unspecified unspecified unspecified  	O	null
11 עד עד עד noun masculine singular absolute unspecified unspecified  	O	null
12 צללים צל צללים noun masculine plural absolute unspecified unspecified  	O	null
13 נחמקים נחמקים נחמקים verb masculine plural unspecified any beinoni  	O	null
14 אלוהי אלוהי אלוהי adjective masculine singular absolute unspecified unspecified  	O	null
15 ינצור נצר ינצור verb masculine singular unspecified 3 future  	O	null
16 ש ש שלומי relativizer/subordinatingConjunction unspecified unspecified unspecified unspecified unspecified 0 
16 לומי לום שלומי noun masculine plural construct unspecified unspecified  	O	null
17 עת עת עת noun feminine singular construct unspecified unspecified  	O	null
18 לב לב לבי noun masculine singular absolute unspecified unspecified  
18 י י לבי possessive masculine-and-feminine singular unspecified 1 unspecified 0 	O	null
19 ינדוד ינדוד ינדוד properName unspecified unspecified unspecified unspecified unspecified  	I_PERS	null
20 ל ל למרחקים preposition unspecified unspecified unspecified unspecified unspecified 0 
20 מרחקים מרחק למרחקים noun masculine plural absolute unspecified unspecified  	O	null
21 . . . punctuation unspecified unspecified unspecified unspecified unspecified  	O	null

0 על על על preposition unspecified unspecified unspecified unspecified unspecified  	O	null
1 גמלי גמל גמלי noun masculine plural construct unspecified unspecified  	O	null
2 אתור תר אתור verb masculine-and-feminine singular unspecified 1 future  	O	null
3 אחבוק חבק אחבוק verb masculine-and-feminine singular unspecified 1 future  	O	null
4 ה ה השחקים definiteArticle unspecified unspecified unspecified unspecified unspecified 0 
4 השחקים שחק השחקים noun masculine plural absolute unspecified unspecified  	O	null
5 כוכבי כוכב כוכבי properName unspecified unspecified unspecified unspecified unspecified  	I_PERS	null
6 יהל יהל יהל properName unspecified unspecified unspecified unspecified unspecified  	I_PERS	null
7 ו ו ויפצח conjunction unspecified unspecified unspecified unspecified unspecified 0 
7 יפצח פצח ויפצח verb masculine singular unspecified 3 future  	O	null
8 ב ב במזמור preposition unspecified unspecified unspecified unspecified unspecified 0 
8 מזמור מזמור במזמור noun masculine singular absolute unspecified unspecified  	O	null
9 ב ב בהוד preposition unspecified unspecified unspecified unspecified unspecified 0 
9 הוד הוד בהוד properName unspecified unspecified unspecified unspecified unspecified  	I_PERS	null
10 מדבר דיבר מדבר verb masculine singular unspecified any beinoni  	O	null
11 אקסם אקסם אקסם properName unspecified unspecified unspecified unspecified unspecified  	O	null
12 בין בין בין preposition unspecified unspecified unspecified unspecified unspecified  	O	null
13 קשתות קשת קשתות noun feminine plural construct unspecified unspecified  	O	null
14 ה ה הדמדומים definiteArticle unspecified unspecified unspecified unspecified unspecified 0 
14 הדמדומים דמדום הדמדומים noun masculine plural absolute unspecified unspecified  	O	null
15 מ מ מגמלי preposition unspecified unspecified unspecified unspecified unspecified 0 
15 גמלי גמל מגמלי noun masculine plural construct unspecified unspecified  	O	null
16 אכרע כרע אכרע verb masculine-and-feminine singular unspecified 1 future  	O	null
17 ו ו ואתפלל conjunction unspecified unspecified unspecified unspecified unspecified 0 
17 אתפלל התפלל ואתפלל verb masculine-and-feminine singular unspecified 1 future  	O	null
18 ב ב בערגת preposition unspecified unspecified unspecified unspecified unspecified 0 
18 ערגת ערגה בערגת noun feminine singular construct unspecified unspecified  	O	null
19 נווד נווד נווד noun masculine singular absolute unspecified unspecified  	O	null
20 ל ל לאלוהיו preposition unspecified unspecified unspecified unspecified unspecified 0 
20 אלוהי אלוהים לאלוהיו noun masculine singular absolute unspecified unspecified  
20 ו ו לאלוהיו possessive masculine singular unspecified 3 unspecified 0 	O	null
21 . . . punctuation unspecified unspecified unspecified unspecified unspecified  	O	null

0 רעמת רעמה רעמת noun feminine singular construct unspecified unspecified  	O	null
1 הרים הר הרים noun masculine plural absolute unspecified unspecified  	O	null
2 סגרה סגר סגרה verb feminine singular unspecified 3 past  	O	null
3 על על עלי preposition unspecified unspecified unspecified unspecified unspecified  
3 י י עלי pronomial masculine-and-feminine singular unspecified 1 unspecified 0 	O	null
4 ו ו ואכלא conjunction unspecified unspecified unspecified unspecified unspecified 0 
4 אכלא כלא ואכלא verb masculine-and-feminine singular unspecified 1 future  	O	null
5 ב ב בקן preposition unspecified unspecified unspecified unspecified unspecified 0 
5 קן קן בקן noun masculine singular construct unspecified unspecified  	O	null
6 נשרים נשר נשרים noun masculine plural absolute unspecified unspecified  	O	null
7 מ מ ממרומים preposition unspecified unspecified unspecified unspecified unspecified 0 
7 מרומים מרום ממרומים noun masculine plural absolute unspecified unspecified  	O	null
8 חפפו חפף חפפו verb masculine-and-feminine plural unspecified 3 past  	O	null
9 משעולי משעול משעולי noun masculine plural construct unspecified unspecified  	O	null
10 דקלים דקל דקלים noun masculine plural absolute unspecified unspecified  	O	null
11 צילם צילם צילם verb masculine singular unspecified 3 past  	O	null
12 פורשים פורש פורשים noun masculine plural absolute unspecified unspecified  	O	null
13 זע זע זע verb masculine singular unspecified 3 past  	O	null
14 מ מ מיתרי preposition unspecified unspecified unspecified unspecified unspecified 0 
14 יתר יתר מיתרי noun masculine singular absolute unspecified unspecified  
14 י י מיתרי possessive masculine-and-feminine singular unspecified 1 unspecified 0 	O	null
15 ב ב ברון preposition unspecified unspecified unspecified unspecified unspecified 0 
15 רון רון ברון properName unspecified unspecified unspecified unspecified unspecified  	I_PERS	null
16 כוכבי כוכב כוכבי properName unspecified unspecified unspecified unspecified unspecified  	I_PERS	null
17 המית המיה המית noun feminine singular construct unspecified unspecified  	O	null
18 שיר שיר שיר properName unspecified unspecified unspecified unspecified unspecified  	I_PERS	null
19 ינעימו הנעים ינעימו verb masculine-and-feminine plural unspecified 3 future  	O	null
20 ענבלים... ענבלים... ענבלים... properName unspecified unspecified unspecified unspecified unspecified  	O	null
21 על על על preposition unspecified unspecified unspecified unspecified unspecified  	O	null
22 גמלי... גמלי... גמלי... verb masculine singular unspecified 2 imperative  	O	null

