0 This This This foreign unspecified unspecified unspecified unspecified unspecified  	I_ORG	null
1 ain't ain't ain't foreign unspecified unspecified unspecified unspecified unspecified  	I_ORG	null
2 a a a foreign unspecified unspecified unspecified unspecified unspecified  	I_ORG	null
3 song song song foreign unspecified unspecified unspecified unspecified unspecified  	I_ORG	null
4 for for for foreign unspecified unspecified unspecified unspecified unspecified  	I_ORG	null
5 the the the foreign unspecified unspecified unspecified unspecified unspecified  	I_ORG	null
6 brokenhearted brokenhearted brokenhearted foreign unspecified unspecified unspecified unspecified unspecified  	I_ORG	null
7 No No No foreign unspecified unspecified unspecified unspecified unspecified  	I_ORG	null
8 silent silent silent foreign unspecified unspecified unspecified unspecified unspecified  	I_ORG	null
9 prayer prayer prayer foreign unspecified unspecified unspecified unspecified unspecified  	I_ORG	null
10 for for for foreign unspecified unspecified unspecified unspecified unspecified  	I_ORG	null
11 the the the foreign unspecified unspecified unspecified unspecified unspecified  	I_ORG	null
12 faith faith faith foreign unspecified unspecified unspecified unspecified unspecified  	I_ORG	null
13 departed departed departed foreign unspecified unspecified unspecified unspecified unspecified  	I_ORG	null
14 And And And foreign unspecified unspecified unspecified unspecified unspecified  	I_ORG	null
15 I I I foreign unspecified unspecified unspecified unspecified unspecified  	I_ORG	null
16 ain't ain't ain't foreign unspecified unspecified unspecified unspecified unspecified  	I_ORG	null
17 gonna gonna gonna foreign unspecified unspecified unspecified unspecified unspecified  	I_ORG	null
18 be be be foreign unspecified unspecified unspecified unspecified unspecified  	I_ORG	null
19 just just just foreign unspecified unspecified unspecified unspecified unspecified  	I_ORG	null
20 a a a foreign unspecified unspecified unspecified unspecified unspecified  	I_ORG	null
21 face face face foreign unspecified unspecified unspecified unspecified unspecified  	I_ORG	null
22 in in in foreign unspecified unspecified unspecified unspecified unspecified  	I_ORG	null
23 the the the foreign unspecified unspecified unspecified unspecified unspecified  	I_ORG	null
24 crowd crowd crowd foreign unspecified unspecified unspecified unspecified unspecified  	I_ORG	null
25 You You You foreign unspecified unspecified unspecified unspecified unspecified  	I_ORG	null
26 ' ' ' punctuation unspecified unspecified unspecified unspecified unspecified  	O	null
27 re re re foreign unspecified unspecified unspecified unspecified unspecified  	I_ORG	null
28 gonna gonna gonna foreign unspecified unspecified unspecified unspecified unspecified  	I_ORG	null
29 hear hear hear foreign unspecified unspecified unspecified unspecified unspecified  	I_ORG	null
30 my my my foreign unspecified unspecified unspecified unspecified unspecified  	I_ORG	null
31 voice voice voice foreign unspecified unspecified unspecified unspecified unspecified  	I_ORG	null
32 when when when foreign unspecified unspecified unspecified unspecified unspecified  	I_ORG	null
33 I I I foreign unspecified unspecified unspecified unspecified unspecified  	I_ORG	null
34 shout shout shout foreign unspecified unspecified unspecified unspecified unspecified  	I_ORG	null
35 it it it foreign unspecified unspecified unspecified unspecified unspecified  	I_ORG	null
36 out out out foreign unspecified unspecified unspecified unspecified unspecified  	I_ORG	null
37 loud loud loud foreign unspecified unspecified unspecified unspecified unspecified  	I_ORG	null

0 It It It foreign unspecified unspecified unspecified unspecified unspecified  	O	null
1 ' ' ' punctuation unspecified unspecified unspecified unspecified unspecified  	O	null
2 s s s foreign unspecified unspecified unspecified unspecified unspecified  	I_ORG	null
3 my my my foreign unspecified unspecified unspecified unspecified unspecified  	I_ORG	null
4 life life life foreign unspecified unspecified unspecified unspecified unspecified  	I_ORG	null
5 It It It foreign unspecified unspecified unspecified unspecified unspecified  	I_ORG	null
6 ' ' ' punctuation unspecified unspecified unspecified unspecified unspecified  	O	null
7 s s s foreign unspecified unspecified unspecified unspecified unspecified  	I_ORG	null
8 now now now foreign unspecified unspecified unspecified unspecified unspecified  	I_ORG	null
9 or or or foreign unspecified unspecified unspecified unspecified unspecified  	I_ORG	null
10 never never never foreign unspecified unspecified unspecified unspecified unspecified  	I_ORG	null
11 I I I foreign unspecified unspecified unspecified unspecified unspecified  	I_ORG	null
12 ain't ain't ain't foreign unspecified unspecified unspecified unspecified unspecified  	I_ORG	null
13 gonna gonna gonna foreign unspecified unspecified unspecified unspecified unspecified  	I_ORG	null
14 live live live foreign unspecified unspecified unspecified unspecified unspecified  	I_ORG	null
15 forever forever forever foreign unspecified unspecified unspecified unspecified unspecified  	I_ORG	null
16 I I I foreign unspecified unspecified unspecified unspecified unspecified  	I_ORG	null
17 just just just foreign unspecified unspecified unspecified unspecified unspecified  	I_ORG	null
18 wanna wanna wanna foreign unspecified unspecified unspecified unspecified unspecified  	I_ORG	null
19 live live live foreign unspecified unspecified unspecified unspecified unspecified  	I_ORG	null
20 while while while foreign unspecified unspecified unspecified unspecified unspecified  	I_ORG	null
21 I I I foreign unspecified unspecified unspecified unspecified unspecified  	I_ORG	null
22 ' ' ' punctuation unspecified unspecified unspecified unspecified unspecified  	O	null
23 m m m foreign unspecified unspecified unspecified unspecified unspecified  	I_ORG	null
24 alive alive alive foreign unspecified unspecified unspecified unspecified unspecified  	I_ORG	null

0 ( ( ( punctuation unspecified unspecified unspecified unspecified unspecified  	O	null
1 It's It's It's foreign unspecified unspecified unspecified unspecified unspecified  	O	null
2 my my my foreign unspecified unspecified unspecified unspecified unspecified  	O	null
3 life life life foreign unspecified unspecified unspecified unspecified unspecified  	O	null
4 ) ) ) punctuation unspecified unspecified unspecified unspecified unspecified  	O	null
5 My My My foreign unspecified unspecified unspecified unspecified unspecified  	I_ORG	null
6 heart heart heart foreign unspecified unspecified unspecified unspecified unspecified  	I_ORG	null
7 is is is foreign unspecified unspecified unspecified unspecified unspecified  	I_ORG	null
8 like like like foreign unspecified unspecified unspecified unspecified unspecified  	I_ORG	null
9 an an an foreign unspecified unspecified unspecified unspecified unspecified  	I_ORG	null
10 open open open foreign unspecified unspecified unspecified unspecified unspecified  	I_ORG	null
11 highway highway highway foreign unspecified unspecified unspecified unspecified unspecified  	I_ORG	null
12 Like Like Like foreign unspecified unspecified unspecified unspecified unspecified  	I_ORG	null
13 Frankie Frankie Frankie foreign unspecified unspecified unspecified unspecified unspecified  	I_ORG	null
14 said said said foreign unspecified unspecified unspecified unspecified unspecified  	I_ORG	null
15 , , , punctuation unspecified unspecified unspecified unspecified unspecified  	O	null
16 " " " punctuation unspecified unspecified unspecified unspecified unspecified  	O	null
17 I I I foreign unspecified unspecified unspecified unspecified unspecified  	I_ORG	null
18 did did did foreign unspecified unspecified unspecified unspecified unspecified  	I_ORG	null
19 it it it foreign unspecified unspecified unspecified unspecified unspecified  	I_ORG	null
20 my my my foreign unspecified unspecified unspecified unspecified unspecified  	I_ORG	null
21 way way way foreign unspecified unspecified unspecified unspecified unspecified  	I_ORG	null
22 " " " punctuation unspecified unspecified unspecified unspecified unspecified  	O	null
23 I I I foreign unspecified unspecified unspecified unspecified unspecified  	I_ORG	null
24 just just just foreign unspecified unspecified unspecified unspecified unspecified  	I_ORG	null
25 wanna wanna wanna foreign unspecified unspecified unspecified unspecified unspecified  	I_ORG	null
26 live live live foreign unspecified unspecified unspecified unspecified unspecified  	I_ORG	null
27 while while while foreign unspecified unspecified unspecified unspecified unspecified  	I_ORG	null
28 I I I foreign unspecified unspecified unspecified unspecified unspecified  	I_ORG	null
29 ' ' ' punctuation unspecified unspecified unspecified unspecified unspecified  	O	null
30 m m m foreign unspecified unspecified unspecified unspecified unspecified  	O	null
31 alive alive alive foreign unspecified unspecified unspecified unspecified unspecified  	O	null
32 ' ' ' punctuation unspecified unspecified unspecified unspecified unspecified  	O	null
33 Cause Cause Cause foreign unspecified unspecified unspecified unspecified unspecified  	I_ORG	null
34 it's it's it's foreign unspecified unspecified unspecified unspecified unspecified  	I_ORG	null
35 my my my foreign unspecified unspecified unspecified unspecified unspecified  	I_ORG	null
36 life life life foreign unspecified unspecified unspecified unspecified unspecified  	I_ORG	null

0 This This This foreign unspecified unspecified unspecified unspecified unspecified  	I_ORG	null
1 is is is foreign unspecified unspecified unspecified unspecified unspecified  	I_ORG	null
2 for for for foreign unspecified unspecified unspecified unspecified unspecified  	I_ORG	null
3 the the the foreign unspecified unspecified unspecified unspecified unspecified  	I_ORG	null
4 ones ones ones foreign unspecified unspecified unspecified unspecified unspecified  	I_ORG	null
5 who who who foreign unspecified unspecified unspecified unspecified unspecified  	I_ORG	null
6 stood stood stood foreign unspecified unspecified unspecified unspecified unspecified  	I_ORG	null
7 their their their foreign unspecified unspecified unspecified unspecified unspecified  	I_ORG	null
8 ground ground ground foreign unspecified unspecified unspecified unspecified unspecified  	I_ORG	null
9 For For For foreign unspecified unspecified unspecified unspecified unspecified  	I_ORG	null
10 Tommy Tommy Tommy foreign unspecified unspecified unspecified unspecified unspecified  	I_ORG	null
11 and and and foreign unspecified unspecified unspecified unspecified unspecified  	I_ORG	null
12 Gina Gina Gina foreign unspecified unspecified unspecified unspecified unspecified  	I_ORG	null
13 who who who foreign unspecified unspecified unspecified unspecified unspecified  	I_ORG	null
14 never never never foreign unspecified unspecified unspecified unspecified unspecified  	I_ORG	null
15 backed backed backed foreign unspecified unspecified unspecified unspecified unspecified  	I_ORG	null
16 down down down foreign unspecified unspecified unspecified unspecified unspecified  	I_ORG	null
17 Tomorrow Tomorrow Tomorrow foreign unspecified unspecified unspecified unspecified unspecified  	I_ORG	null
18 ' ' ' punctuation unspecified unspecified unspecified unspecified unspecified  	O	null
19 s s s foreign unspecified unspecified unspecified unspecified unspecified  	I_ORG	null
20 getting getting getting foreign unspecified unspecified unspecified unspecified unspecified  	I_ORG	null
21 harder harder harder foreign unspecified unspecified unspecified unspecified unspecified  	I_ORG	null
22 , , , punctuation unspecified unspecified unspecified unspecified unspecified  	O	null
23 make make make foreign unspecified unspecified unspecified unspecified unspecified  	I_ORG	null
24 no no no foreign unspecified unspecified unspecified unspecified unspecified  	I_ORG	null
25 mistake mistake mistake foreign unspecified unspecified unspecified unspecified unspecified  	I_ORG	null
26 Luck Luck Luck foreign unspecified unspecified unspecified unspecified unspecified  	I_ORG	null
27 ain't ain't ain't foreign unspecified unspecified unspecified unspecified unspecified  	I_ORG	null
28 even even even foreign unspecified unspecified unspecified unspecified unspecified  	I_ORG	null
29 lucky lucky lucky foreign unspecified unspecified unspecified unspecified unspecified  	I_ORG	null
30 , , , punctuation unspecified unspecified unspecified unspecified unspecified  	O	null
31 gotta gotta gotta foreign unspecified unspecified unspecified unspecified unspecified  	I_ORG	null
32 make make make foreign unspecified unspecified unspecified unspecified unspecified  	I_ORG	null
33 your your your foreign unspecified unspecified unspecified unspecified unspecified  	I_ORG	null
34 own own own foreign unspecified unspecified unspecified unspecified unspecified  	I_ORG	null
35 breaks breaks breaks foreign unspecified unspecified unspecified unspecified unspecified  	I_ORG	null

0 It It It foreign unspecified unspecified unspecified unspecified unspecified  	O	null
1 ' ' ' punctuation unspecified unspecified unspecified unspecified unspecified  	O	null
2 s s s foreign unspecified unspecified unspecified unspecified unspecified  	I_ORG	null
3 my my my foreign unspecified unspecified unspecified unspecified unspecified  	I_ORG	null
4 life life life foreign unspecified unspecified unspecified unspecified unspecified  	I_ORG	null
5 And And And foreign unspecified unspecified unspecified unspecified unspecified  	I_ORG	null
6 it's it's it's foreign unspecified unspecified unspecified unspecified unspecified  	I_ORG	null
7 now now now foreign unspecified unspecified unspecified unspecified unspecified  	I_ORG	null
8 or or or foreign unspecified unspecified unspecified unspecified unspecified  	I_ORG	null
9 never never never foreign unspecified unspecified unspecified unspecified unspecified  	I_ORG	null
10 I I I foreign unspecified unspecified unspecified unspecified unspecified  	I_ORG	null
11 ain't ain't ain't foreign unspecified unspecified unspecified unspecified unspecified  	I_ORG	null
12 gonna gonna gonna foreign unspecified unspecified unspecified unspecified unspecified  	I_ORG	null
13 live live live foreign unspecified unspecified unspecified unspecified unspecified  	I_ORG	null
14 forever forever forever foreign unspecified unspecified unspecified unspecified unspecified  	I_ORG	null
15 I I I foreign unspecified unspecified unspecified unspecified unspecified  	I_ORG	null
16 just just just foreign unspecified unspecified unspecified unspecified unspecified  	I_ORG	null
17 wanna wanna wanna foreign unspecified unspecified unspecified unspecified unspecified  	I_ORG	null
18 live live live foreign unspecified unspecified unspecified unspecified unspecified  	I_ORG	null
19 while while while foreign unspecified unspecified unspecified unspecified unspecified  	I_ORG	null
20 I I I foreign unspecified unspecified unspecified unspecified unspecified  	I_ORG	null
21 ' ' ' punctuation unspecified unspecified unspecified unspecified unspecified  	O	null
22 m m m foreign unspecified unspecified unspecified unspecified unspecified  	I_ORG	null
23 alive alive alive foreign unspecified unspecified unspecified unspecified unspecified  	I_ORG	null

