0 If If If foreign unspecified unspecified unspecified unspecified unspecified  	I_ORG	null
1 tomorrow tomorrow tomorrow foreign unspecified unspecified unspecified unspecified unspecified  	I_ORG	null
2 is is is foreign unspecified unspecified unspecified unspecified unspecified  	I_ORG	null
3 a a a foreign unspecified unspecified unspecified unspecified unspecified  	I_ORG	null
4 judgement judgement judgement foreign unspecified unspecified unspecified unspecified unspecified  	I_ORG	null
5 day day day foreign unspecified unspecified unspecified unspecified unspecified  	I_ORG	null
6 And And And foreign unspecified unspecified unspecified unspecified unspecified  	I_ORG	null
7 I I I foreign unspecified unspecified unspecified unspecified unspecified  	I_ORG	null
8 am am am foreign unspecified unspecified unspecified unspecified unspecified  	I_ORG	null
9 standin standin standin foreign unspecified unspecified unspecified unspecified unspecified  	I_ORG	null
10 ' ' ' punctuation unspecified unspecified unspecified unspecified unspecified  	O	null
11 on on on foreign unspecified unspecified unspecified unspecified unspecified  	I_ORG	null
12 the the the foreign unspecified unspecified unspecified unspecified unspecified  	I_ORG	null
13 front front front foreign unspecified unspecified unspecified unspecified unspecified  	I_ORG	null
14 line line line foreign unspecified unspecified unspecified unspecified unspecified  	I_ORG	null
15 And And And foreign unspecified unspecified unspecified unspecified unspecified  	I_ORG	null
16 the the the foreign unspecified unspecified unspecified unspecified unspecified  	I_ORG	null
17 lord lord lord foreign unspecified unspecified unspecified unspecified unspecified  	I_ORG	null
18 ask ask ask foreign unspecified unspecified unspecified unspecified unspecified  	I_ORG	null
19 me me me foreign unspecified unspecified unspecified unspecified unspecified  	I_ORG	null
20 what what what foreign unspecified unspecified unspecified unspecified unspecified  	I_ORG	null
21 I I I foreign unspecified unspecified unspecified unspecified unspecified  	I_ORG	null
22 did did did foreign unspecified unspecified unspecified unspecified unspecified  	I_ORG	null
23 with with with foreign unspecified unspecified unspecified unspecified unspecified  	I_ORG	null
24 my my my foreign unspecified unspecified unspecified unspecified unspecified  	I_ORG	null
25 life life life foreign unspecified unspecified unspecified unspecified unspecified  	I_ORG	null
26 I I I foreign unspecified unspecified unspecified unspecified unspecified  	I_ORG	null
27 will will will foreign unspecified unspecified unspecified unspecified unspecified  	I_ORG	null
28 say say say foreign unspecified unspecified unspecified unspecified unspecified  	I_ORG	null
29 I I I foreign unspecified unspecified unspecified unspecified unspecified  	I_ORG	null
30 spent spent spent foreign unspecified unspecified unspecified unspecified unspecified  	I_ORG	null
31 it it it foreign unspecified unspecified unspecified unspecified unspecified  	I_ORG	null
32 with with with foreign unspecified unspecified unspecified unspecified unspecified  	I_ORG	null
33 you you you foreign unspecified unspecified unspecified unspecified unspecified  	I_ORG	null
34 … … … punctuation unspecified unspecified unspecified unspecified unspecified  	O	null
35 . . . punctuation unspecified unspecified unspecified unspecified unspecified  	O	null

0 If If If foreign unspecified unspecified unspecified unspecified unspecified  	I_ORG	null
1 I I I foreign unspecified unspecified unspecified unspecified unspecified  	I_ORG	null
2 wake wake wake foreign unspecified unspecified unspecified unspecified unspecified  	I_ORG	null
3 up up up foreign unspecified unspecified unspecified unspecified unspecified  	I_ORG	null
4 in in in foreign unspecified unspecified unspecified unspecified unspecified  	I_ORG	null
5 world world world foreign unspecified unspecified unspecified unspecified unspecified  	I_ORG	null
6 war war war foreign unspecified unspecified unspecified unspecified unspecified  	I_ORG	null
7 ###NUMBER### ###NUMBER### ###NUMBER### numeral unspecified unspecified unspecified unspecified unspecified  	I_LOC	null
8 I I I foreign unspecified unspecified unspecified unspecified unspecified  	I_ORG	null
9 see see see foreign unspecified unspecified unspecified unspecified unspecified  	I_ORG	null
10 destruction destruction destruction foreign unspecified unspecified unspecified unspecified unspecified  	I_ORG	null
11 and and and foreign unspecified unspecified unspecified unspecified unspecified  	I_ORG	null
12 poverty poverty poverty foreign unspecified unspecified unspecified unspecified unspecified  	I_ORG	null
13 And And And foreign unspecified unspecified unspecified unspecified unspecified  	I_ORG	null
14 I I I foreign unspecified unspecified unspecified unspecified unspecified  	I_ORG	null
15 feel feel feel foreign unspecified unspecified unspecified unspecified unspecified  	I_ORG	null
16 like like like foreign unspecified unspecified unspecified unspecified unspecified  	I_ORG	null
17 I I I foreign unspecified unspecified unspecified unspecified unspecified  	I_ORG	null
18 want want want foreign unspecified unspecified unspecified unspecified unspecified  	I_ORG	null
19 to to to foreign unspecified unspecified unspecified unspecified unspecified  	I_ORG	null
20 go go go foreign unspecified unspecified unspecified unspecified unspecified  	I_ORG	null
21 home home home foreign unspecified unspecified unspecified unspecified unspecified  	I_ORG	null
22 - - - punctuation unspecified unspecified unspecified unspecified unspecified  	O	null
23 It It It foreign unspecified unspecified unspecified unspecified unspecified  	I_ORG	null
24 ' ' ' punctuation unspecified unspecified unspecified unspecified unspecified  	O	null
25 s s s foreign unspecified unspecified unspecified unspecified unspecified  	O	null
26 okay okay okay foreign unspecified unspecified unspecified unspecified unspecified  	O	null
27 , , , punctuation unspecified unspecified unspecified unspecified unspecified  	O	null
28 if if if foreign unspecified unspecified unspecified unspecified unspecified  	O	null
29 you you you foreign unspecified unspecified unspecified unspecified unspecified  	O	null
30 comin comin comin foreign unspecified unspecified unspecified unspecified unspecified  	O	null
31 ' ' ' punctuation unspecified unspecified unspecified unspecified unspecified  	O	null
32 with with with foreign unspecified unspecified unspecified unspecified unspecified  	O	null
33 me me me foreign unspecified unspecified unspecified unspecified unspecified  	O	null
34 – – – punctuation unspecified unspecified unspecified unspecified unspecified  	O	null

0 ' ' ' punctuation unspecified unspecified unspecified unspecified unspecified  	O	null
1 cause cause cause foreign unspecified unspecified unspecified unspecified unspecified  	I_ORG	null
2 your your your foreign unspecified unspecified unspecified unspecified unspecified  	I_ORG	null
3 love love love foreign unspecified unspecified unspecified unspecified unspecified  	I_ORG	null
4 is is is foreign unspecified unspecified unspecified unspecified unspecified  	I_ORG	null
5 my my my foreign unspecified unspecified unspecified unspecified unspecified  	I_ORG	null
6 love love love foreign unspecified unspecified unspecified unspecified unspecified  	I_ORG	null
7 And And And foreign unspecified unspecified unspecified unspecified unspecified  	I_ORG	null
8 my my my foreign unspecified unspecified unspecified unspecified unspecified  	I_ORG	null
9 love love love foreign unspecified unspecified unspecified unspecified unspecified  	I_ORG	null
10 is is is foreign unspecified unspecified unspecified unspecified unspecified  	I_ORG	null
11 your your your foreign unspecified unspecified unspecified unspecified unspecified  	I_ORG	null
12 love love love foreign unspecified unspecified unspecified unspecified unspecified  	I_ORG	null
13 It It It foreign unspecified unspecified unspecified unspecified unspecified  	I_ORG	null
14 would would would foreign unspecified unspecified unspecified unspecified unspecified  	I_ORG	null
15 take take take foreign unspecified unspecified unspecified unspecified unspecified  	I_ORG	null
16 an an an foreign unspecified unspecified unspecified unspecified unspecified  	I_ORG	null
17 eternity eternity eternity foreign unspecified unspecified unspecified unspecified unspecified  	I_ORG	null
18 to to to foreign unspecified unspecified unspecified unspecified unspecified  	I_ORG	null
19 break break break foreign unspecified unspecified unspecified unspecified unspecified  	I_ORG	null
20 us us us foreign unspecified unspecified unspecified unspecified unspecified  	I_ORG	null
21 … … … punctuation unspecified unspecified unspecified unspecified unspecified  	O	null
22 And And And foreign unspecified unspecified unspecified unspecified unspecified  	I_ORG	null
23 the the the foreign unspecified unspecified unspecified unspecified unspecified  	I_ORG	null
24 chains chains chains foreign unspecified unspecified unspecified unspecified unspecified  	I_ORG	null
25 of of of foreign unspecified unspecified unspecified unspecified unspecified  	I_ORG	null
26 Amistad Amistad Amistad foreign unspecified unspecified unspecified unspecified unspecified  	I_ORG	null
27 couldn't couldn't couldn't foreign unspecified unspecified unspecified unspecified unspecified  	I_ORG	null
28 hold hold hold foreign unspecified unspecified unspecified unspecified unspecified  	I_ORG	null
29 us us us foreign unspecified unspecified unspecified unspecified unspecified  	I_ORG	null

0 If If If foreign unspecified unspecified unspecified unspecified unspecified  	I_ORG	null
1 I I I foreign unspecified unspecified unspecified unspecified unspecified  	I_ORG	null
2 lose lose lose foreign unspecified unspecified unspecified unspecified unspecified  	I_ORG	null
3 my my my foreign unspecified unspecified unspecified unspecified unspecified  	I_ORG	null
4 fame fame fame foreign unspecified unspecified unspecified unspecified unspecified  	I_ORG	null
5 and and and foreign unspecified unspecified unspecified unspecified unspecified  	I_ORG	null
6 fortune fortune fortune foreign unspecified unspecified unspecified unspecified unspecified  	I_ORG	null
7 , , , punctuation unspecified unspecified unspecified unspecified unspecified  	O	null
8 And And And foreign unspecified unspecified unspecified unspecified unspecified  	O	null
9 I I I foreign unspecified unspecified unspecified unspecified unspecified  	O	null
10 ' ' ' punctuation unspecified unspecified unspecified unspecified unspecified  	O	null
11 m m m foreign unspecified unspecified unspecified unspecified unspecified  	I_ORG	null
12 homeless homeless homeless foreign unspecified unspecified unspecified unspecified unspecified  	I_ORG	null
13 on on on foreign unspecified unspecified unspecified unspecified unspecified  	I_ORG	null
14 the the the foreign unspecified unspecified unspecified unspecified unspecified  	I_ORG	null
15 street street street foreign unspecified unspecified unspecified unspecified unspecified  	I_ORG	null
16 .. .. .. punctuation unspecified unspecified unspecified unspecified unspecified  	O	null

0 And And And foreign unspecified unspecified unspecified unspecified unspecified  	O	null
1 I I I foreign unspecified unspecified unspecified unspecified unspecified  	O	null
2 ' ' ' punctuation unspecified unspecified unspecified unspecified unspecified  	O	null
3 m m m foreign unspecified unspecified unspecified unspecified unspecified  	O	null
4 sleepin sleepin sleepin foreign unspecified unspecified unspecified unspecified unspecified  	O	null
5 ' ' ' punctuation unspecified unspecified unspecified unspecified unspecified  	O	null
6 in in in foreign unspecified unspecified unspecified unspecified unspecified  	I_ORG	null
7 grand grand grand foreign unspecified unspecified unspecified unspecified unspecified  	I_ORG	null
8 central central central foreign unspecified unspecified unspecified unspecified unspecified  	I_ORG	null
9 station station station foreign unspecified unspecified unspecified unspecified unspecified  	I_ORG	null
10 It It It foreign unspecified unspecified unspecified unspecified unspecified  	I_ORG	null
11 ' ' ' punctuation unspecified unspecified unspecified unspecified unspecified  	O	null
12 s s s foreign unspecified unspecified unspecified unspecified unspecified  	I_ORG	null
13 okay okay okay foreign unspecified unspecified unspecified unspecified unspecified  	I_ORG	null
14 if if if foreign unspecified unspecified unspecified unspecified unspecified  	I_ORG	null
15 you're you're you're foreign unspecified unspecified unspecified unspecified unspecified  	I_ORG	null
16 sleepin sleepin sleepin foreign unspecified unspecified unspecified unspecified unspecified  	I_ORG	null
17 ' ' ' punctuation unspecified unspecified unspecified unspecified unspecified  	O	null
18 with with with foreign unspecified unspecified unspecified unspecified unspecified  	I_ORG	null
19 me me me foreign unspecified unspecified unspecified unspecified unspecified  	I_ORG	null

0 As As As foreign unspecified unspecified unspecified unspecified unspecified  	O	null
1 the the the foreign unspecified unspecified unspecified unspecified unspecified  	O	null
2 years years years foreign unspecified unspecified unspecified unspecified unspecified  	O	null
3 , , , punctuation unspecified unspecified unspecified unspecified unspecified  	O	null
4 they they they foreign unspecified unspecified unspecified unspecified unspecified  	I_ORG	null
5 pass pass pass foreign unspecified unspecified unspecified unspecified unspecified  	I_ORG	null
6 us us us foreign unspecified unspecified unspecified unspecified unspecified  	I_ORG	null
7 by by by foreign unspecified unspecified unspecified unspecified unspecified  	I_ORG	null
8 We We We foreign unspecified unspecified unspecified unspecified unspecified  	I_ORG	null
9 stay stay stay foreign unspecified unspecified unspecified unspecified unspecified  	I_ORG	null
10 young young young foreign unspecified unspecified unspecified unspecified unspecified  	I_ORG	null
11 through through through foreign unspecified unspecified unspecified unspecified unspecified  	I_ORG	null
12 each each each foreign unspecified unspecified unspecified unspecified unspecified  	I_ORG	null
13 other other other foreign unspecified unspecified unspecified unspecified unspecified  	I_ORG	null
14 eyes eyes eyes foreign unspecified unspecified unspecified unspecified unspecified  	I_ORG	null
15 .. .. .. punctuation unspecified unspecified unspecified unspecified unspecified  	O	null

0 And And And foreign unspecified unspecified unspecified unspecified unspecified  	I_ORG	null
1 no no no foreign unspecified unspecified unspecified unspecified unspecified  	I_ORG	null
2 matter matter matter foreign unspecified unspecified unspecified unspecified unspecified  	I_ORG	null
3 how how how foreign unspecified unspecified unspecified unspecified unspecified  	I_ORG	null
4 old old old foreign unspecified unspecified unspecified unspecified unspecified  	I_ORG	null
5 we we we foreign unspecified unspecified unspecified unspecified unspecified  	I_ORG	null
6 get get get foreign unspecified unspecified unspecified unspecified unspecified  	I_ORG	null
7 It It It foreign unspecified unspecified unspecified unspecified unspecified  	I_ORG	null
8 ' ' ' punctuation unspecified unspecified unspecified unspecified unspecified  	O	null
9 s s s foreign unspecified unspecified unspecified unspecified unspecified  	O	null
10 okay okay okay foreign unspecified unspecified unspecified unspecified unspecified  	O	null
11 , , , punctuation unspecified unspecified unspecified unspecified unspecified  	O	null
12 as as as foreign unspecified unspecified unspecified unspecified unspecified  	I_ORG	null
13 long long long foreign unspecified unspecified unspecified unspecified unspecified  	I_ORG	null
14 as as as foreign unspecified unspecified unspecified unspecified unspecified  	I_ORG	null
15 I I I foreign unspecified unspecified unspecified unspecified unspecified  	I_ORG	null
16 got got got foreign unspecified unspecified unspecified unspecified unspecified  	I_ORG	null
17 you you you foreign unspecified unspecified unspecified unspecified unspecified  	I_ORG	null
18 babe babe babe foreign unspecified unspecified unspecified unspecified unspecified  	I_ORG	null
19 … … … punctuation unspecified unspecified unspecified unspecified unspecified  	O	null

0 ' ' ' punctuation unspecified unspecified unspecified unspecified unspecified  	O	null
1 cause cause cause foreign unspecified unspecified unspecified unspecified unspecified  	O	null
2 your your your foreign unspecified unspecified unspecified unspecified unspecified  	O	null
3 love love love foreign unspecified unspecified unspecified unspecified unspecified  	O	null
4 … … … punctuation unspecified unspecified unspecified unspecified unspecified  	O	null
5 … … … punctuation unspecified unspecified unspecified unspecified unspecified  	O	null
6 … … … punctuation unspecified unspecified unspecified unspecified unspecified  	O	null
7 … … … punctuation unspecified unspecified unspecified unspecified unspecified  	O	null
8 … … … punctuation unspecified unspecified unspecified unspecified unspecified  	O	null
9 … … … punctuation unspecified unspecified unspecified unspecified unspecified  	O	null
10 . . . punctuation unspecified unspecified unspecified unspecified unspecified  	O	null

0 If If If foreign unspecified unspecified unspecified unspecified unspecified  	I_ORG	null
1 I I I foreign unspecified unspecified unspecified unspecified unspecified  	I_ORG	null
2 should should should foreign unspecified unspecified unspecified unspecified unspecified  	I_ORG	null
3 die die die foreign unspecified unspecified unspecified unspecified unspecified  	I_ORG	null
4 this this this foreign unspecified unspecified unspecified unspecified unspecified  	I_ORG	null
5 very very very foreign unspecified unspecified unspecified unspecified unspecified  	I_ORG	null
6 day day day foreign unspecified unspecified unspecified unspecified unspecified  	I_ORG	null
7 Don Don Don foreign unspecified unspecified unspecified unspecified unspecified  	I_ORG	null
8 ' ' ' punctuation unspecified unspecified unspecified unspecified unspecified  	O	null
9 t t t foreign unspecified unspecified unspecified unspecified unspecified  	O	null
10 cry cry cry foreign unspecified unspecified unspecified unspecified unspecified  	O	null
11 , , , punctuation unspecified unspecified unspecified unspecified unspecified  	O	null
12 ' ' ' punctuation unspecified unspecified unspecified unspecified unspecified  	O	null
13 cause cause cause foreign unspecified unspecified unspecified unspecified unspecified  	I_ORG	null
14 on on on foreign unspecified unspecified unspecified unspecified unspecified  	I_ORG	null
15 earth earth earth foreign unspecified unspecified unspecified unspecified unspecified  	I_ORG	null
16 we we we foreign unspecified unspecified unspecified unspecified unspecified  	I_ORG	null
17 wasn't wasn't wasn't foreign unspecified unspecified unspecified unspecified unspecified  	I_ORG	null
18 meant meant meant foreign unspecified unspecified unspecified unspecified unspecified  	I_ORG	null
19 to to to foreign unspecified unspecified unspecified unspecified unspecified  	I_ORG	null
20 stay stay stay foreign unspecified unspecified unspecified unspecified unspecified  	I_ORG	null
21 And And And foreign unspecified unspecified unspecified unspecified unspecified  	I_ORG	null
22 no no no foreign unspecified unspecified unspecified unspecified unspecified  	I_ORG	null
23 matter matter matter foreign unspecified unspecified unspecified unspecified unspecified  	I_ORG	null
24 what what what foreign unspecified unspecified unspecified unspecified unspecified  	I_ORG	null
25 people people people foreign unspecified unspecified unspecified unspecified unspecified  	I_ORG	null
26 say say say foreign unspecified unspecified unspecified unspecified unspecified  	I_ORG	null
27 I I I foreign unspecified unspecified unspecified unspecified unspecified  	I_ORG	null
28 ' ' ' punctuation unspecified unspecified unspecified unspecified unspecified  	O	null
29 ll ll ll foreign unspecified unspecified unspecified unspecified unspecified  	I_ORG	null
30 be be be foreign unspecified unspecified unspecified unspecified unspecified  	I_ORG	null
31 waiting waiting waiting foreign unspecified unspecified unspecified unspecified unspecified  	I_ORG	null
32 for for for foreign unspecified unspecified unspecified unspecified unspecified  	I_ORG	null
33 you you you foreign unspecified unspecified unspecified unspecified unspecified  	I_ORG	null
34 , , , punctuation unspecified unspecified unspecified unspecified unspecified  	O	null
35 after after after foreign unspecified unspecified unspecified unspecified unspecified  	I_ORG	null
36 judgement judgement judgement foreign unspecified unspecified unspecified unspecified unspecified  	I_ORG	null
37 day day day foreign unspecified unspecified unspecified unspecified unspecified  	I_ORG	null

0 ' ' ' punctuation unspecified unspecified unspecified unspecified unspecified  	O	null
1 cause cause cause foreign unspecified unspecified unspecified unspecified unspecified  	O	null
2 your your your foreign unspecified unspecified unspecified unspecified unspecified  	O	null
3 love love love foreign unspecified unspecified unspecified unspecified unspecified  	O	null
4 … … … punctuation unspecified unspecified unspecified unspecified unspecified  	O	null
5 … … … punctuation unspecified unspecified unspecified unspecified unspecified  	O	null
6 … … … punctuation unspecified unspecified unspecified unspecified unspecified  	O	null
7 … … … punctuation unspecified unspecified unspecified unspecified unspecified  	O	null
8 … … … punctuation unspecified unspecified unspecified unspecified unspecified  	O	null
9 . . . punctuation unspecified unspecified unspecified unspecified unspecified  	O	null

