0 What What What foreign unspecified unspecified unspecified unspecified unspecified  	I_ORG	null
1 a a a foreign unspecified unspecified unspecified unspecified unspecified  	I_ORG	null
2 beautiful beautiful beautiful foreign unspecified unspecified unspecified unspecified unspecified  	I_ORG	null
3 day day day foreign unspecified unspecified unspecified unspecified unspecified  	I_ORG	null
4 , , , punctuation unspecified unspecified unspecified unspecified unspecified  	O	null
5 not not not foreign unspecified unspecified unspecified unspecified unspecified  	I_ORG	null
6 a a a foreign unspecified unspecified unspecified unspecified unspecified  	I_ORG	null
7 cloud cloud cloud foreign unspecified unspecified unspecified unspecified unspecified  	I_ORG	null
8 in in in foreign unspecified unspecified unspecified unspecified unspecified  	I_ORG	null
9 the the the foreign unspecified unspecified unspecified unspecified unspecified  	I_ORG	null
10 sky sky sky foreign unspecified unspecified unspecified unspecified unspecified  	I_ORG	null
11 , , , punctuation unspecified unspecified unspecified unspecified unspecified  	O	null
12 Leaves Leaves Leaves foreign unspecified unspecified unspecified unspecified unspecified  	I_ORG	null
13 are are are foreign unspecified unspecified unspecified unspecified unspecified  	I_ORG	null
14 dancing dancing dancing foreign unspecified unspecified unspecified unspecified unspecified  	I_ORG	null
15 in in in foreign unspecified unspecified unspecified unspecified unspecified  	I_ORG	null
16 the the the foreign unspecified unspecified unspecified unspecified unspecified  	I_ORG	null
17 wind wind wind foreign unspecified unspecified unspecified unspecified unspecified  	I_ORG	null
18 without without without foreign unspecified unspecified unspecified unspecified unspecified  	I_ORG	null
19 asking asking asking foreign unspecified unspecified unspecified unspecified unspecified  	I_ORG	null
20 why why why foreign unspecified unspecified unspecified unspecified unspecified  	I_ORG	null
21 . . . punctuation unspecified unspecified unspecified unspecified unspecified  	O	null

0 It It It foreign unspecified unspecified unspecified unspecified unspecified  	O	null
1 ’ ’ ’ punctuation unspecified unspecified unspecified unspecified unspecified  	O	null
2 s s s foreign unspecified unspecified unspecified unspecified unspecified  	I_ORG	null
3 a a a foreign unspecified unspecified unspecified unspecified unspecified  	I_ORG	null
4 day day day foreign unspecified unspecified unspecified unspecified unspecified  	I_ORG	null
5 full full full foreign unspecified unspecified unspecified unspecified unspecified  	I_ORG	null
6 of of of foreign unspecified unspecified unspecified unspecified unspecified  	I_ORG	null
7 joy joy joy foreign unspecified unspecified unspecified unspecified unspecified  	I_ORG	null
8 , , , punctuation unspecified unspecified unspecified unspecified unspecified  	O	null
9 when when when foreign unspecified unspecified unspecified unspecified unspecified  	I_ORG	null
10 the the the foreign unspecified unspecified unspecified unspecified unspecified  	I_ORG	null
11 mind mind mind foreign unspecified unspecified unspecified unspecified unspecified  	I_ORG	null
12 stays stays stays foreign unspecified unspecified unspecified unspecified unspecified  	I_ORG	null
13 so so so foreign unspecified unspecified unspecified unspecified unspecified  	I_ORG	null
14 clear clear clear foreign unspecified unspecified unspecified unspecified unspecified  	I_ORG	null
15 , , , punctuation unspecified unspecified unspecified unspecified unspecified  	O	null
16 The The The foreign unspecified unspecified unspecified unspecified unspecified  	I_ORG	null
17 hummingbird hummingbird hummingbird foreign unspecified unspecified unspecified unspecified unspecified  	I_ORG	null
18 the the the foreign unspecified unspecified unspecified unspecified unspecified  	I_ORG	null
19 nectar nectar nectar foreign unspecified unspecified unspecified unspecified unspecified  	I_ORG	null
20 drinks drinks drinks foreign unspecified unspecified unspecified unspecified unspecified  	I_ORG	null
21 So So So foreign unspecified unspecified unspecified unspecified unspecified  	I_ORG	null
22 near near near foreign unspecified unspecified unspecified unspecified unspecified  	I_ORG	null
23 . . . punctuation unspecified unspecified unspecified unspecified unspecified  	O	null

0 What What What foreign unspecified unspecified unspecified unspecified unspecified  	I_ORG	null
1 a a a foreign unspecified unspecified unspecified unspecified unspecified  	I_ORG	null
2 good good good foreign unspecified unspecified unspecified unspecified unspecified  	I_ORG	null
3 day day day foreign unspecified unspecified unspecified unspecified unspecified  	I_ORG	null
4 to to to foreign unspecified unspecified unspecified unspecified unspecified  	I_ORG	null
5 dream dream dream foreign unspecified unspecified unspecified unspecified unspecified  	I_ORG	null
6 , , , punctuation unspecified unspecified unspecified unspecified unspecified  	O	null
7 To To To foreign unspecified unspecified unspecified unspecified unspecified  	O	null
8 write write write foreign unspecified unspecified unspecified unspecified unspecified  	O	null
9 a a a foreign unspecified unspecified unspecified unspecified unspecified  	O	null
10 song song song foreign unspecified unspecified unspecified unspecified unspecified  	O	null
11 , , , punctuation unspecified unspecified unspecified unspecified unspecified  	O	null
12 or or or foreign unspecified unspecified unspecified unspecified unspecified  	I_ORG	null
13 call call call foreign unspecified unspecified unspecified unspecified unspecified  	I_ORG	null
14 on on on foreign unspecified unspecified unspecified unspecified unspecified  	I_ORG	null
15 a a a foreign unspecified unspecified unspecified unspecified unspecified  	I_ORG	null
16 friend friend friend foreign unspecified unspecified unspecified unspecified unspecified  	I_ORG	null
17 , , , punctuation unspecified unspecified unspecified unspecified unspecified  	O	null
18 Bring Bring Bring foreign unspecified unspecified unspecified unspecified unspecified  	I_ORG	null
19 some some some foreign unspecified unspecified unspecified unspecified unspecified  	I_ORG	null
20 flowers flowers flowers foreign unspecified unspecified unspecified unspecified unspecified  	I_ORG	null
21 to to to foreign unspecified unspecified unspecified unspecified unspecified  	I_ORG	null
22 her her her foreign unspecified unspecified unspecified unspecified unspecified  	I_ORG	null
23 , , , punctuation unspecified unspecified unspecified unspecified unspecified  	O	null
24 or or or foreign unspecified unspecified unspecified unspecified unspecified  	O	null
25 him him him foreign unspecified unspecified unspecified unspecified unspecified  	O	null
26 . . . punctuation unspecified unspecified unspecified unspecified unspecified  	O	null

0 Perfect Perfect Perfect foreign unspecified unspecified unspecified unspecified unspecified  	I_ORG	null
1 day day day foreign unspecified unspecified unspecified unspecified unspecified  	I_ORG	null
2 for for for foreign unspecified unspecified unspecified unspecified unspecified  	I_ORG	null
3 a a a foreign unspecified unspecified unspecified unspecified unspecified  	I_ORG	null
4 swim swim swim foreign unspecified unspecified unspecified unspecified unspecified  	I_ORG	null
5 , , , punctuation unspecified unspecified unspecified unspecified unspecified  	O	null
6 Or Or Or foreign unspecified unspecified unspecified unspecified unspecified  	I_ORG	null
7 climb climb climb foreign unspecified unspecified unspecified unspecified unspecified  	I_ORG	null
8 a a a foreign unspecified unspecified unspecified unspecified unspecified  	I_ORG	null
9 mountain mountain mountain foreign unspecified unspecified unspecified unspecified unspecified  	I_ORG	null
10 hand hand hand foreign unspecified unspecified unspecified unspecified unspecified  	I_ORG	null
11 in in in foreign unspecified unspecified unspecified unspecified unspecified  	I_ORG	null
12 hand hand hand foreign unspecified unspecified unspecified unspecified unspecified  	I_ORG	null
13 to to to foreign unspecified unspecified unspecified unspecified unspecified  	I_ORG	null
14 the the the foreign unspecified unspecified unspecified unspecified unspecified  	I_ORG	null
15 top top top foreign unspecified unspecified unspecified unspecified unspecified  	I_ORG	null
16 , , , punctuation unspecified unspecified unspecified unspecified unspecified  	O	null
17 With With With foreign unspecified unspecified unspecified unspecified unspecified  	O	null
18 Lisa Lisa Lisa foreign unspecified unspecified unspecified unspecified unspecified  	O	null
19 , , , punctuation unspecified unspecified unspecified unspecified unspecified  	O	null
20 or or or foreign unspecified unspecified unspecified unspecified unspecified  	O	null
21 Jim Jim Jim foreign unspecified unspecified unspecified unspecified unspecified  	O	null
22 . . . punctuation unspecified unspecified unspecified unspecified unspecified  	O	null

0 What What What foreign unspecified unspecified unspecified unspecified unspecified  	I_ORG	null
1 a a a foreign unspecified unspecified unspecified unspecified unspecified  	I_ORG	null
2 glorious glorious glorious foreign unspecified unspecified unspecified unspecified unspecified  	I_ORG	null
3 time time time foreign unspecified unspecified unspecified unspecified unspecified  	I_ORG	null
4 , , , punctuation unspecified unspecified unspecified unspecified unspecified  	O	null
5 so so so foreign unspecified unspecified unspecified unspecified unspecified  	I_ORG	null
6 much much much foreign unspecified unspecified unspecified unspecified unspecified  	I_ORG	null
7 peace peace peace foreign unspecified unspecified unspecified unspecified unspecified  	I_ORG	null
8 in in in foreign unspecified unspecified unspecified unspecified unspecified  	I_ORG	null
9 the the the foreign unspecified unspecified unspecified unspecified unspecified  	I_ORG	null
10 air air air foreign unspecified unspecified unspecified unspecified unspecified  	I_ORG	null
11 , , , punctuation unspecified unspecified unspecified unspecified unspecified  	O	null
12 All All All foreign unspecified unspecified unspecified unspecified unspecified  	I_ORG	null
13 is is is foreign unspecified unspecified unspecified unspecified unspecified  	I_ORG	null
14 perfect perfect perfect foreign unspecified unspecified unspecified unspecified unspecified  	I_ORG	null
15 with with with foreign unspecified unspecified unspecified unspecified unspecified  	I_ORG	null
16 the the the foreign unspecified unspecified unspecified unspecified unspecified  	I_ORG	null
17 world world world foreign unspecified unspecified unspecified unspecified unspecified  	I_ORG	null
18 , , , punctuation unspecified unspecified unspecified unspecified unspecified  	O	null
19 I I I foreign unspecified unspecified unspecified unspecified unspecified  	O	null
20 swear swear swear foreign unspecified unspecified unspecified unspecified unspecified  	O	null
21 . . . punctuation unspecified unspecified unspecified unspecified unspecified  	O	null

0 Did Did Did foreign unspecified unspecified unspecified unspecified unspecified  	I_ORG	null
1 not not not foreign unspecified unspecified unspecified unspecified unspecified  	I_ORG	null
2 hear hear hear foreign unspecified unspecified unspecified unspecified unspecified  	I_ORG	null
3 any any any foreign unspecified unspecified unspecified unspecified unspecified  	I_ORG	null
4 news news news foreign unspecified unspecified unspecified unspecified unspecified  	I_ORG	null
5 , , , punctuation unspecified unspecified unspecified unspecified unspecified  	O	null
6 Not Not Not foreign unspecified unspecified unspecified unspecified unspecified  	I_ORG	null
7 in in in foreign unspecified unspecified unspecified unspecified unspecified  	I_ORG	null
8 the the the foreign unspecified unspecified unspecified unspecified unspecified  	I_ORG	null
9 papers papers papers foreign unspecified unspecified unspecified unspecified unspecified  	I_ORG	null
10 and and and foreign unspecified unspecified unspecified unspecified unspecified  	I_ORG	null
11 not not not foreign unspecified unspecified unspecified unspecified unspecified  	I_ORG	null
12 even even even foreign unspecified unspecified unspecified unspecified unspecified  	I_ORG	null
13 on on on foreign unspecified unspecified unspecified unspecified unspecified  	I_ORG	null
14 T T T foreign unspecified unspecified unspecified unspecified unspecified  	I_ORG	null
15 - - - punctuation unspecified unspecified unspecified unspecified unspecified  	O	null
16 V V V foreign unspecified unspecified unspecified unspecified unspecified  	O	null
17 , , , punctuation unspecified unspecified unspecified unspecified unspecified  	O	null
18 It It It foreign unspecified unspecified unspecified unspecified unspecified  	I_ORG	null
19 is is is foreign unspecified unspecified unspecified unspecified unspecified  	I_ORG	null
20 time time time foreign unspecified unspecified unspecified unspecified unspecified  	I_ORG	null
21 to to to foreign unspecified unspecified unspecified unspecified unspecified  	I_ORG	null
22 schmooze schmooze schmooze foreign unspecified unspecified unspecified unspecified unspecified  	I_ORG	null
23 , , , punctuation unspecified unspecified unspecified unspecified unspecified  	O	null
24 forget forget forget foreign unspecified unspecified unspecified unspecified unspecified  	I_ORG	null
25 the the the foreign unspecified unspecified unspecified unspecified unspecified  	I_ORG	null
26 troubles troubles troubles foreign unspecified unspecified unspecified unspecified unspecified  	I_ORG	null
27 of of of foreign unspecified unspecified unspecified unspecified unspecified  	I_ORG	null
28 the the the foreign unspecified unspecified unspecified unspecified unspecified  	I_ORG	null
29 world world world foreign unspecified unspecified unspecified unspecified unspecified  	I_ORG	null
30 , , , punctuation unspecified unspecified unspecified unspecified unspecified  	O	null
31 It It It foreign unspecified unspecified unspecified unspecified unspecified  	O	null
32 ’ ’ ’ punctuation unspecified unspecified unspecified unspecified unspecified  	O	null
33 s s s foreign unspecified unspecified unspecified unspecified unspecified  	I_ORG	null
34 cool cool cool foreign unspecified unspecified unspecified unspecified unspecified  	I_ORG	null
35 just just just foreign unspecified unspecified unspecified unspecified unspecified  	I_ORG	null
36 to to to foreign unspecified unspecified unspecified unspecified unspecified  	I_ORG	null
37 be be be foreign unspecified unspecified unspecified unspecified unspecified  	I_ORG	null
38 . . . punctuation unspecified unspecified unspecified unspecified unspecified  	O	null

0 What What What foreign unspecified unspecified unspecified unspecified unspecified  	I_ORG	null
1 a a a foreign unspecified unspecified unspecified unspecified unspecified  	I_ORG	null
2 beautiful beautiful beautiful foreign unspecified unspecified unspecified unspecified unspecified  	I_ORG	null
3 day day day foreign unspecified unspecified unspecified unspecified unspecified  	I_ORG	null
4 not not not foreign unspecified unspecified unspecified unspecified unspecified  	I_ORG	null
5 a a a foreign unspecified unspecified unspecified unspecified unspecified  	I_ORG	null
6 cloud cloud cloud foreign unspecified unspecified unspecified unspecified unspecified  	I_ORG	null
7 in in in foreign unspecified unspecified unspecified unspecified unspecified  	I_ORG	null
8 the the the foreign unspecified unspecified unspecified unspecified unspecified  	I_ORG	null
9 sky sky sky foreign unspecified unspecified unspecified unspecified unspecified  	I_ORG	null
10 , , , punctuation unspecified unspecified unspecified unspecified unspecified  	O	null
11 I I I foreign unspecified unspecified unspecified unspecified unspecified  	I_ORG	null
12 don’t don’t don’t foreign unspecified unspecified unspecified unspecified unspecified  	I_ORG	null
13 recall recall recall foreign unspecified unspecified unspecified unspecified unspecified  	I_ORG	null
14 a a a foreign unspecified unspecified unspecified unspecified unspecified  	I_ORG	null
15 day day day foreign unspecified unspecified unspecified unspecified unspecified  	I_ORG	null
16 like like like foreign unspecified unspecified unspecified unspecified unspecified  	I_ORG	null
17 this this this foreign unspecified unspecified unspecified unspecified unspecified  	I_ORG	null
18 ; ; ; punctuation unspecified unspecified unspecified unspecified unspecified  	O	null
19 I I I foreign unspecified unspecified unspecified unspecified unspecified  	O	null
20 ’ ’ ’ punctuation unspecified unspecified unspecified unspecified unspecified  	O	null
21 m m m foreign unspecified unspecified unspecified unspecified unspecified  	O	null
22 going going going foreign unspecified unspecified unspecified unspecified unspecified  	O	null
23 to to to foreign unspecified unspecified unspecified unspecified unspecified  	O	null
24 cry cry cry foreign unspecified unspecified unspecified unspecified unspecified  	O	null
25 , , , punctuation unspecified unspecified unspecified unspecified unspecified  	O	null
26 I I I foreign unspecified unspecified unspecified unspecified unspecified  	O	null
27 ’ ’ ’ punctuation unspecified unspecified unspecified unspecified unspecified  	O	null
28 m m m foreign unspecified unspecified unspecified unspecified unspecified  	O	null
29 going going going foreign unspecified unspecified unspecified unspecified unspecified  	O	null
30 to to to foreign unspecified unspecified unspecified unspecified unspecified  	O	null
31 cry cry cry foreign unspecified unspecified unspecified unspecified unspecified  	O	null
32 , , , punctuation unspecified unspecified unspecified unspecified unspecified  	O	null
33 I I I foreign unspecified unspecified unspecified unspecified unspecified  	O	null
34 ’ ’ ’ punctuation unspecified unspecified unspecified unspecified unspecified  	O	null
35 m m m foreign unspecified unspecified unspecified unspecified unspecified  	O	null
36 so so so foreign unspecified unspecified unspecified unspecified unspecified  	O	null
37 high high high foreign unspecified unspecified unspecified unspecified unspecified  	O	null
38 . . . punctuation unspecified unspecified unspecified unspecified unspecified  	O	null

0 It It It foreign unspecified unspecified unspecified unspecified unspecified  	O	null
1 ’ ’ ’ punctuation unspecified unspecified unspecified unspecified unspecified  	O	null
2 s s s foreign unspecified unspecified unspecified unspecified unspecified  	I_ORG	null
3 the the the foreign unspecified unspecified unspecified unspecified unspecified  	I_ORG	null
4 end end end foreign unspecified unspecified unspecified unspecified unspecified  	I_ORG	null
5 of of of foreign unspecified unspecified unspecified unspecified unspecified  	I_ORG	null
6 the the the foreign unspecified unspecified unspecified unspecified unspecified  	I_ORG	null
7 day day day foreign unspecified unspecified unspecified unspecified unspecified  	I_ORG	null
8 , , , punctuation unspecified unspecified unspecified unspecified unspecified  	O	null
9 the the the foreign unspecified unspecified unspecified unspecified unspecified  	O	null
10 sun sun sun foreign unspecified unspecified unspecified unspecified unspecified  	O	null
11 says says says foreign unspecified unspecified unspecified unspecified unspecified  	O	null
12 farewell farewell farewell foreign unspecified unspecified unspecified unspecified unspecified  	O	null
13 , , , punctuation unspecified unspecified unspecified unspecified unspecified  	O	null
14 Moon Moon Moon foreign unspecified unspecified unspecified unspecified unspecified  	I_ORG	null
15 is is is foreign unspecified unspecified unspecified unspecified unspecified  	I_ORG	null
16 looking looking looking foreign unspecified unspecified unspecified unspecified unspecified  	I_ORG	null
17 down down down foreign unspecified unspecified unspecified unspecified unspecified  	I_ORG	null
18 on on on foreign unspecified unspecified unspecified unspecified unspecified  	I_ORG	null
19 us us us foreign unspecified unspecified unspecified unspecified unspecified  	I_ORG	null
20 , , , punctuation unspecified unspecified unspecified unspecified unspecified  	O	null
21 wishing wishing wishing foreign unspecified unspecified unspecified unspecified unspecified  	O	null
22 us us us foreign unspecified unspecified unspecified unspecified unspecified  	O	null
23 well well well foreign unspecified unspecified unspecified unspecified unspecified  	O	null
24 . . . punctuation unspecified unspecified unspecified unspecified unspecified  	O	null

0 I I I foreign unspecified unspecified unspecified unspecified unspecified  	O	null
1 ’ ’ ’ punctuation unspecified unspecified unspecified unspecified unspecified  	O	null
2 m m m foreign unspecified unspecified unspecified unspecified unspecified  	O	null
3 closing closing closing foreign unspecified unspecified unspecified unspecified unspecified  	O	null
4 my my my foreign unspecified unspecified unspecified unspecified unspecified  	O	null
5 eyes eyes eyes foreign unspecified unspecified unspecified unspecified unspecified  	O	null
6 , , , punctuation unspecified unspecified unspecified unspecified unspecified  	O	null
7 falling falling falling foreign unspecified unspecified unspecified unspecified unspecified  	I_ORG	null
8 so so so foreign unspecified unspecified unspecified unspecified unspecified  	I_ORG	null
9 fast fast fast foreign unspecified unspecified unspecified unspecified unspecified  	I_ORG	null
10 into into into foreign unspecified unspecified unspecified unspecified unspecified  	I_ORG	null
11 my my my foreign unspecified unspecified unspecified unspecified unspecified  	I_ORG	null
12 self self self foreign unspecified unspecified unspecified unspecified unspecified  	I_ORG	null
13 On On On foreign unspecified unspecified unspecified unspecified unspecified  	I_ORG	null
14 the the the foreign unspecified unspecified unspecified unspecified unspecified  	I_ORG	null
15 other other other foreign unspecified unspecified unspecified unspecified unspecified  	I_ORG	null
16 side side side foreign unspecified unspecified unspecified unspecified unspecified  	I_ORG	null
17 . . . punctuation unspecified unspecified unspecified unspecified unspecified  	O	null

