0 After After After foreign unspecified unspecified unspecified unspecified unspecified  	I_ORG	null
1 all all all foreign unspecified unspecified unspecified unspecified unspecified  	I_ORG	null
2 the the the foreign unspecified unspecified unspecified unspecified unspecified  	I_ORG	null
3 love love love foreign unspecified unspecified unspecified unspecified unspecified  	I_ORG	null
4 is is is foreign unspecified unspecified unspecified unspecified unspecified  	I_ORG	null
5 gone gone gone foreign unspecified unspecified unspecified unspecified unspecified  	I_ORG	null
6 , , , punctuation unspecified unspecified unspecified unspecified unspecified  	O	null
7 Rising Rising Rising foreign unspecified unspecified unspecified unspecified unspecified  	O	null
8 hands hands hands foreign unspecified unspecified unspecified unspecified unspecified  	O	null
9 around around around foreign unspecified unspecified unspecified unspecified unspecified  	O	null
10 me me me foreign unspecified unspecified unspecified unspecified unspecified  	O	null
11 . . . punctuation unspecified unspecified unspecified unspecified unspecified  	O	null

0 Shirtless Shirtless Shirtless foreign unspecified unspecified unspecified unspecified unspecified  	I_ORG	null
1 men men men foreign unspecified unspecified unspecified unspecified unspecified  	I_ORG	null
2 and and and foreign unspecified unspecified unspecified unspecified unspecified  	I_ORG	null
3 painted painted painted foreign unspecified unspecified unspecified unspecified unspecified  	I_ORG	null
4 boys boys boys foreign unspecified unspecified unspecified unspecified unspecified  	I_ORG	null
5 , , , punctuation unspecified unspecified unspecified unspecified unspecified  	O	null
6 Side Side Side foreign unspecified unspecified unspecified unspecified unspecified  	O	null
7 by by by foreign unspecified unspecified unspecified unspecified unspecified  	O	null
8 side side side foreign unspecified unspecified unspecified unspecified unspecified  	O	null
9 , , , punctuation unspecified unspecified unspecified unspecified unspecified  	O	null
10 all all all foreign unspecified unspecified unspecified unspecified unspecified  	O	null
11 alone alone alone foreign unspecified unspecified unspecified unspecified unspecified  	O	null
12 , , , punctuation unspecified unspecified unspecified unspecified unspecified  	O	null
13 Red Red Red foreign unspecified unspecified unspecified unspecified unspecified  	O	null
14 light light light foreign unspecified unspecified unspecified unspecified unspecified  	O	null
15 . . . punctuation unspecified unspecified unspecified unspecified unspecified  	O	null

0 Walking Walking Walking foreign unspecified unspecified unspecified unspecified unspecified  	I_ORG	null
1 through through through foreign unspecified unspecified unspecified unspecified unspecified  	I_ORG	null
2 a a a foreign unspecified unspecified unspecified unspecified unspecified  	I_ORG	null
3 city city city foreign unspecified unspecified unspecified unspecified unspecified  	I_ORG	null
4 i i i foreign unspecified unspecified unspecified unspecified unspecified  	I_ORG	null
5 don't don't don't foreign unspecified unspecified unspecified unspecified unspecified  	I_ORG	null
6 know know know foreign unspecified unspecified unspecified unspecified unspecified  	I_ORG	null
7 , , , punctuation unspecified unspecified unspecified unspecified unspecified  	O	null
8 Dancing Dancing Dancing foreign unspecified unspecified unspecified unspecified unspecified  	I_ORG	null
9 on on on foreign unspecified unspecified unspecified unspecified unspecified  	I_ORG	null
10 a a a foreign unspecified unspecified unspecified unspecified unspecified  	I_ORG	null
11 stage stage stage foreign unspecified unspecified unspecified unspecified unspecified  	I_ORG	null
12 of of of foreign unspecified unspecified unspecified unspecified unspecified  	I_ORG	null
13 endless endless endless foreign unspecified unspecified unspecified unspecified unspecified  	I_ORG	null
14 shows shows shows foreign unspecified unspecified unspecified unspecified unspecified  	I_ORG	null
15 , , , punctuation unspecified unspecified unspecified unspecified unspecified  	O	null
16 Smoke Smoke Smoke foreign unspecified unspecified unspecified unspecified unspecified  	I_ORG	null
17 machines machines machines foreign unspecified unspecified unspecified unspecified unspecified  	I_ORG	null
18 in in in foreign unspecified unspecified unspecified unspecified unspecified  	I_ORG	null
19 my my my foreign unspecified unspecified unspecified unspecified unspecified  	I_ORG	null
20 eyes eyes eyes foreign unspecified unspecified unspecified unspecified unspecified  	I_ORG	null
21 , , , punctuation unspecified unspecified unspecified unspecified unspecified  	O	null
22 No No No foreign unspecified unspecified unspecified unspecified unspecified  	I_ORG	null
23 one one one foreign unspecified unspecified unspecified unspecified unspecified  	I_ORG	null
24 hears hears hears foreign unspecified unspecified unspecified unspecified unspecified  	I_ORG	null
25 when when when foreign unspecified unspecified unspecified unspecified unspecified  	I_ORG	null
26 you you you foreign unspecified unspecified unspecified unspecified unspecified  	I_ORG	null
27 cry cry cry foreign unspecified unspecified unspecified unspecified unspecified  	I_ORG	null
28 . . . punctuation unspecified unspecified unspecified unspecified unspecified  	O	null

0 After After After foreign unspecified unspecified unspecified unspecified unspecified  	I_ORG	null
1 all all all foreign unspecified unspecified unspecified unspecified unspecified  	I_ORG	null
2 the the the foreign unspecified unspecified unspecified unspecified unspecified  	I_ORG	null
3 love love love foreign unspecified unspecified unspecified unspecified unspecified  	I_ORG	null
4 is is is foreign unspecified unspecified unspecified unspecified unspecified  	I_ORG	null
5 gone gone gone foreign unspecified unspecified unspecified unspecified unspecified  	I_ORG	null
6 , , , punctuation unspecified unspecified unspecified unspecified unspecified  	O	null
7 Diving Diving Diving foreign unspecified unspecified unspecified unspecified unspecified  	O	null
8 into into into foreign unspecified unspecified unspecified unspecified unspecified  	O	null
9 music music music foreign unspecified unspecified unspecified unspecified unspecified  	O	null
10 . . . punctuation unspecified unspecified unspecified unspecified unspecified  	O	null

0 Taxi Taxi Taxi foreign unspecified unspecified unspecified unspecified unspecified  	I_ORG	null
1 runs runs runs foreign unspecified unspecified unspecified unspecified unspecified  	I_ORG	null
2 through through through foreign unspecified unspecified unspecified unspecified unspecified  	I_ORG	null
3 city city city foreign unspecified unspecified unspecified unspecified unspecified  	I_ORG	null
4 streets streets streets foreign unspecified unspecified unspecified unspecified unspecified  	I_ORG	null
5 , , , punctuation unspecified unspecified unspecified unspecified unspecified  	O	null
6 Through Through Through foreign unspecified unspecified unspecified unspecified unspecified  	O	null
7 the the the foreign unspecified unspecified unspecified unspecified unspecified  	O	null
8 night night night foreign unspecified unspecified unspecified unspecified unspecified  	O	null
9 , , , punctuation unspecified unspecified unspecified unspecified unspecified  	O	null
10 Through Through Through foreign unspecified unspecified unspecified unspecified unspecified  	O	null
11 my my my foreign unspecified unspecified unspecified unspecified unspecified  	O	null
12 heart heart heart foreign unspecified unspecified unspecified unspecified unspecified  	O	null
13 , , , punctuation unspecified unspecified unspecified unspecified unspecified  	O	null
14 Red Red Red foreign unspecified unspecified unspecified unspecified unspecified  	O	null
15 light light light foreign unspecified unspecified unspecified unspecified unspecified  	O	null
16 . . . punctuation unspecified unspecified unspecified unspecified unspecified  	O	null

