0 על על על preposition unspecified unspecified unspecified unspecified unspecified  	O	null
1 נהרות נהר נהרות noun masculine plural construct unspecified unspecified  	O	null
2 בבל בבל בבל properName unspecified unspecified unspecified unspecified unspecified  	I_LOC	null
3 שם שם שם adverb unspecified unspecified unspecified unspecified unspecified  	O	null
4 ישבנו יישב ישבנו verb masculine-and-feminine plural unspecified 1 past  	O	null
5 גם גם גם conjunction unspecified unspecified unspecified unspecified unspecified  	O	null
6 בכינו בכה בכינו verb masculine-and-feminine plural unspecified 1 past  	O	null
7 ב ב בזכרנו preposition unspecified unspecified unspecified unspecified unspecified 0 
7 זכר זכר בזכרנו noun masculine singular absolute unspecified unspecified  
7 נו נו בזכרנו possessive masculine-and-feminine plural unspecified 1 unspecified 0 	O	null
8 את את את at-preposition unspecified unspecified unspecified unspecified unspecified  	O	null
9 ציון ציון ציון properName unspecified unspecified unspecified unspecified unspecified  	I_PERS	null
10 על על על preposition unspecified unspecified unspecified unspecified unspecified  	O	null
11 ערבים ערב ערבים noun masculine plural absolute unspecified unspecified  	O	null
12 בתוך תיווך בתוכה verb unspecified unspecified unspecified unspecified infinitive  
12 ה ה בתוכה accusative-or-nominative feminine singular unspecified 3 unspecified 0 	O	null
13 תלינו תלה תלינו verb masculine-and-feminine plural unspecified 1 past  	O	null
14 כינורותי כינור כינורותינו noun masculine plural absolute unspecified unspecified  
14 נו נו כינורותינו possessive masculine-and-feminine plural unspecified 1 unspecified 0 	O	null
15 כי כי כי conjunction unspecified unspecified unspecified unspecified unspecified  	O	null
16 שם שם שם adverb unspecified unspecified unspecified unspecified unspecified  	O	null
17 שאלון שאלון שאלונו noun masculine singular absolute unspecified unspecified  
17 ו ו שאלונו possessive masculine singular unspecified 3 unspecified 0 	O	null
18 שובי שבה שובינו participle masculine plural unspecified any unspecified  
18 נו נו שובינו possessive masculine-and-feminine plural unspecified 1 unspecified 0 	O	null
19 דברי דיבר דברי verb feminine singular unspecified 2 imperative  	O	null
20 שיר שיר שיר properName unspecified unspecified unspecified unspecified unspecified  	I_PERS	null
21 ותוללנו ותוללנו ותוללנו properName unspecified unspecified unspecified unspecified unspecified  	I_PERS	null
22 שמחה שמחה שמחה properName feminine singular unspecified unspecified unspecified  	I_PERS	null
23 שיר שיר שירו noun masculine singular absolute unspecified unspecified  
23 ו ו שירו possessive masculine singular unspecified 3 unspecified 0 	O	null
24 ל ל לנו preposition unspecified unspecified unspecified unspecified unspecified  
24 נו נו לנו pronomial masculine-and-feminine plural unspecified 1 unspecified 0 	O	null
25 מ מ משיר preposition unspecified unspecified unspecified unspecified unspecified 0 
25 שיר שיר משיר noun masculine singular construct unspecified unspecified  	O	null
26 ציון ציון ציון properName unspecified unspecified unspecified unspecified unspecified  	I_ORG	null
27 איך איך איך interrogative unspecified unspecified unspecified unspecified unspecified  	O	null
28 נשיר נשיר נשיר adjective masculine singular construct unspecified unspecified  	O	null
29 את את את at-preposition unspecified unspecified unspecified unspecified unspecified  	O	null
30 שיר שיר שיר noun masculine singular construct unspecified unspecified  	O	null
31 ה' ה' ה' numeral unspecified unspecified unspecified unspecified unspecified  	O	null
32 על על על preposition unspecified unspecified unspecified unspecified unspecified  	O	null
33 אדמת אדמה אדמת noun feminine singular construct unspecified unspecified  	O	null
34 נכר ניכר נכר verb masculine singular unspecified any beinoni  	O	null
35 אם אם אם conjunction unspecified unspecified unspecified unspecified unspecified  	O	null
36 אשכחך אשכחך אשכחך properName unspecified unspecified unspecified unspecified unspecified  	I_PERS	null
37 ירושלים ירושלים ירושלים properName unspecified unspecified unspecified unspecified unspecified  	I_LOC	null
38 תשכח שכח תשכח verb feminine singular unspecified 3 future  	O	null
39 ימיני ימין ימיני noun masculine plural construct unspecified unspecified  	O	null
40 תדבק דבק תדבק verb feminine singular unspecified 3 future  	O	null
41 לשוני לשוני לשוני adjective masculine singular absolute unspecified unspecified  	O	null
42 ל ל לחיכי preposition unspecified unspecified unspecified unspecified unspecified 0 
42 חיכי חיך לחיכי noun masculine plural construct unspecified unspecified  	O	null
43 אם אם אם conjunction unspecified unspecified unspecified unspecified unspecified  	O	null
44 לא לא לא negation unspecified unspecified unspecified unspecified unspecified  	O	null
45 אזכרכי אזכרכי אזכרכי adjective masculine singular absolute unspecified unspecified  	O	null
46 אם אם אם conjunction unspecified unspecified unspecified unspecified unspecified  	O	null
47 לא לא לא negation unspecified unspecified unspecified unspecified unspecified  	O	null
48 אעלה העלה אעלה verb masculine-and-feminine singular unspecified 1 future  	O	null
49 את את את at-preposition unspecified unspecified unspecified unspecified unspecified  	O	null
50 ירושלים ירושלים ירושלים properName unspecified unspecified unspecified unspecified unspecified  	I_LOC	null
51 על על על preposition unspecified unspecified unspecified unspecified unspecified  	O	null
52 ראש ראש ראש noun masculine singular construct unspecified unspecified  	O	null
53 ש ש שמחתי relativizer/subordinatingConjunction unspecified unspecified unspecified unspecified unspecified 0 
53 מ מ שמחתי preposition unspecified unspecified unspecified unspecified unspecified 0 
53 חתי חת שמחתי noun masculine plural construct unspecified unspecified  	O	null
54 זכור זכר זכור participle masculine singular absolute any unspecified  	O	null
55 ה' ה' ה' numeral unspecified unspecified unspecified unspecified unspecified  	O	null
56 ל ל לבני preposition unspecified unspecified unspecified unspecified unspecified 0 
56 בני בן לבני noun masculine plural construct unspecified unspecified  	O	null
57 אדום אדום אדום properName masculine singular unspecified unspecified unspecified  	I_LOC	null
58 את את את at-preposition unspecified unspecified unspecified unspecified unspecified  	O	null
59 יום יום יום noun masculine singular construct unspecified unspecified  	I_DATE	null
60 ירושלים ירושלים ירושלים properName unspecified unspecified unspecified unspecified unspecified  	I_DATE	null
61 ה ה האומרים definiteArticle unspecified unspecified unspecified unspecified unspecified 0 
61 האומרים אמר האומרים participle masculine plural absolute any unspecified  	O	null
62 ערו עירה ערו verb masculine-and-feminine plural unspecified 2 imperative  	O	null
63 ערו עירה ערו verb masculine-and-feminine plural unspecified 2 imperative  	O	null
64 עד עד עד preposition unspecified unspecified unspecified unspecified unspecified  	O	null
65 ה ה היסוד definiteArticle unspecified unspecified unspecified unspecified unspecified 0 
65 היסוד יסוד היסוד noun masculine singular absolute unspecified unspecified  	O	null
66 ב ב בה preposition unspecified unspecified unspecified unspecified unspecified  
66 ה ה בה pronomial feminine singular unspecified 3 unspecified 0 	O	null
67 בת בת בת noun feminine singular construct unspecified unspecified  	O	null
68 בבל בבל בבל properName unspecified unspecified unspecified unspecified unspecified  	I_LOC	null
69 ה ה השדודה definiteArticle unspecified unspecified unspecified unspecified unspecified 0 
69 השדודה שדד השדודה participle feminine singular absolute any unspecified  	O	null
70 אשרי אישר אשרי verb feminine singular unspecified 2 imperative  	O	null
71 ש ש שישלם relativizer/subordinatingConjunction unspecified unspecified unspecified unspecified unspecified 0 
71 ישלם שילם שישלם verb masculine singular unspecified 3 future  	O	null
72 ל ל לך preposition unspecified unspecified unspecified unspecified unspecified  
72 ך ך לך pronomial feminine singular unspecified 2 unspecified 0 	O	null
73 את את את at-preposition unspecified unspecified unspecified unspecified unspecified  	O	null
74 גמול גמול גמולך noun masculine singular absolute unspecified unspecified  
74 ך ך גמולך possessive feminine singular unspecified 2 unspecified 0 	O	null
75 ש ש שגמלת relativizer/subordinatingConjunction unspecified unspecified unspecified unspecified unspecified 0 
75 גמלת גמלה שגמלת noun feminine singular construct unspecified unspecified  	O	null
76 ל ל לנו preposition unspecified unspecified unspecified unspecified unspecified  
76 נו נו לנו pronomial masculine-and-feminine plural unspecified 1 unspecified 0 	O	null
77 אשרי אישר אשרי verb feminine singular unspecified 2 imperative  	O	null
78 ש ש שיאחז relativizer/subordinatingConjunction unspecified unspecified unspecified unspecified unspecified 0 
78 יאחז איחז שיאחז verb masculine singular unspecified 3 future  	O	null
79 ו ו וניפץ conjunction unspecified unspecified unspecified unspecified unspecified 0 
79 ניפץ ניפץ וניפץ verb masculine singular unspecified 3 past  	O	null
80 את את את at-preposition unspecified unspecified unspecified unspecified unspecified  	O	null
81 עוללי עולל עולליך noun masculine plural absolute unspecified unspecified  
81 ך ך עולליך possessive feminine singular unspecified 2 unspecified 0 	O	null
82 אל אל אל modal masculine singular unspecified unspecified past  	O	null
83 ה ה הסלע definiteArticle unspecified unspecified unspecified unspecified unspecified 0 
83 הסלע סלע הסלע noun masculine singular absolute unspecified unspecified  	O	null
84 . . . punctuation unspecified unspecified unspecified unspecified unspecified  	O	null

