0 חבבי חיבב חבבי verb feminine singular unspecified 2 imperative  	O	null
1 דיאלי דיאלי דיאלי noun masculine plural construct unspecified unspecified  	O	null
2 יא יא יא properName unspecified unspecified unspecified unspecified unspecified  	I_LOC	null
3 - - - punctuation unspecified unspecified unspecified unspecified unspecified  	O	null
4 חביבי חביב חביבי adjective masculine plural construct unspecified unspecified  	O	null
5 סתך סתך סתך noun masculine singular construct unspecified unspecified  	O	null
6 חביבי חביב חביבי adjective masculine plural construct unspecified unspecified  	O	null
7 יה יה יה properName unspecified unspecified unspecified unspecified unspecified  	I_LOC	null
8 - - - punctuation unspecified unspecified unspecified unspecified unspecified  	O	null
9 עיני עין עיני noun feminine plural construct unspecified unspecified  	O	null
10 חביבי חביב חביבי adjective masculine plural construct unspecified unspecified  	O	null
11 דיאלי דיאלי דיאלי noun masculine plural construct unspecified unspecified  	O	null
12 יא יא יא noun masculine singular construct unspecified unspecified  	O	null
13 - - - punctuation unspecified unspecified unspecified unspecified unspecified  	O	null
14 חביבי חביב חביבי adjective masculine plural construct unspecified unspecified  	O	null
15 סתך סתך סתך noun masculine singular construct unspecified unspecified  	O	null
16 סתך סתך סתך noun masculine singular construct unspecified unspecified  	O	null
17 יה יה יה properName unspecified unspecified unspecified unspecified unspecified  	I_LOC	null
18 - - - punctuation unspecified unspecified unspecified unspecified unspecified  	O	null
19 עיני עין עיני noun feminine plural construct unspecified unspecified  	O	null

0 יה יה יה properName unspecified unspecified unspecified unspecified unspecified  	I_LOC	null
1 - - - punctuation unspecified unspecified unspecified unspecified unspecified  	O	null
2 מולנה מל מולנה verb feminine plural unspecified 2 imperative  	O	null
3 תן נתן תן verb masculine singular unspecified 2 imperative  	O	null
4 שמחה שמחה שמחה properName feminine singular unspecified unspecified unspecified  	I_PERS	null
5 יה יה יה properName unspecified unspecified unspecified unspecified unspecified  	I_PERS	null
6 - - - punctuation unspecified unspecified unspecified unspecified unspecified  	O	null
7 מולנה מל מולנה verb feminine plural unspecified 2 imperative  	O	null
8 ג'ביל ג'ביל ג'ביל properName unspecified unspecified unspecified unspecified unspecified  	I_PERS	null
9 פרחה פרח פרחה verb feminine singular unspecified 3 past  	O	null
10 יה יה יה properName unspecified unspecified unspecified unspecified unspecified  	I_PERS	null
11 – – – punctuation unspecified unspecified unspecified unspecified unspecified  	O	null
12 מולנה מל מולנה verb feminine plural unspecified 2 imperative  	O	null

0 יה יה יה properName unspecified unspecified unspecified unspecified unspecified  	I_LOC	null
1 - - - punctuation unspecified unspecified unspecified unspecified unspecified  	O	null
2 מולנה מל מולנה verb feminine plural unspecified 2 imperative  	O	null
3 חביבי חביב חביבי adjective masculine plural construct unspecified unspecified  	O	null
4 דיאלי דיאלי דיאלי noun masculine plural construct unspecified unspecified  	O	null
5 יא יא יא properName unspecified unspecified unspecified unspecified unspecified  	I_LOC	null
6 - - - punctuation unspecified unspecified unspecified unspecified unspecified  	O	null
7 מולנה מל מולנה verb feminine plural unspecified 2 imperative  	O	null
8 ג'ביל ג'ביל ג'ביל properName unspecified unspecified unspecified unspecified unspecified  	I_PERS	null
9 פרחה פרח פרחה verb feminine singular unspecified 3 past  	O	null

