0 היו הוא היו copula masculine plural unspecified 2 imperative  	O	null
1 רבים רב רבים adjective masculine plural absolute unspecified unspecified  	O	null
2 ו ו וטובים conjunction unspecified unspecified unspecified unspecified unspecified 0 
2 טובים טוב וטובים adjective masculine plural absolute unspecified unspecified  	O	null
3 ש ש שהבינו relativizer/subordinatingConjunction unspecified unspecified unspecified unspecified unspecified 0 
3 הבינו הבין שהבינו verb masculine-and-feminine plural unspecified 3 past  	O	null
4 ש ש שהזמן relativizer/subordinatingConjunction unspecified unspecified unspecified unspecified unspecified 0 
4 ה ה שהזמן definiteArticle unspecified unspecified unspecified unspecified unspecified 0 
4 הזמן זמן שהזמן noun masculine singular absolute unspecified unspecified  	O	null
5 נ נ נ properName unspecified unspecified unspecified unspecified unspecified  	I_PERS	null
6 נ נ נ properName unspecified unspecified unspecified unspecified unspecified  	I_PERS	null
7 נ נ נ properName unspecified unspecified unspecified unspecified unspecified  	I_PERS	null
8 נ נ נ properName unspecified unspecified unspecified unspecified unspecified  	I_PERS	null
9 נ נ נ properName unspecified unspecified unspecified unspecified unspecified  	I_PERS	null
10 נ נ נ properName unspecified unspecified unspecified unspecified unspecified  	I_PERS	null
11 נ נ נ properName unspecified unspecified unspecified unspecified unspecified  	I_PERS	null
12 נ נ נ properName unspecified unspecified unspecified unspecified unspecified  	I_PERS	null
13 ן ן ן properName unspecified unspecified unspecified unspecified unspecified  	I_PERS	null
14 אין אין אין negation unspecified unspecified unspecified unspecified unspecified  	O	null
15 בעצם בעצם בעצם adverb unspecified unspecified unspecified unspecified unspecified  	O	null
16 זמן זמן זמן noun masculine singular absolute unspecified unspecified  	O	null

