0 אני הוא אני pronoun masculine-and-feminine singular unspecified 1 unspecified  	O	null
1 כל כול כל quantifier unspecified unspecified construct unspecified unspecified  	O	null
2 כך כך כך pronoun unspecified unspecified unspecified unspecified unspecified  	O	null
3 אוהב אהב אוהב verb masculine singular unspecified any beinoni  	O	null
4 ש ש שמספרים relativizer/subordinatingConjunction unspecified unspecified unspecified unspecified unspecified 0 
4 מספרים סיפר שמספרים verb masculine plural unspecified any beinoni  	O	null
5 ל ל לי preposition unspecified unspecified unspecified unspecified unspecified  
5 י י לי pronomial masculine-and-feminine singular unspecified 1 unspecified 0 	O	null
6 סיפורים סיפור סיפורים noun masculine plural absolute unspecified unspecified  	O	null
7 ו ו ולפעמים conjunction unspecified unspecified unspecified unspecified unspecified 0 
7 לפעמים לפעמים ולפעמים adverb unspecified unspecified unspecified unspecified unspecified  	O	null
8 שירים שיר שירים noun masculine plural absolute unspecified unspecified  	O	null
9 יפים יפה יפים adjective masculine plural absolute unspecified unspecified  	O	null
10 עושים עשה עושים verb masculine plural unspecified any beinoni  	O	null
11 ל ל לי preposition unspecified unspecified unspecified unspecified unspecified  
11 י י לי pronomial masculine-and-feminine singular unspecified 1 unspecified 0 	O	null
12 משהו משהו משהו noun masculine singular absolute unspecified unspecified  	O	null
13 ב ב בלב preposition unspecified unspecified unspecified unspecified unspecified 0 
13 לב לב בלב noun masculine singular absolute unspecified unspecified  	O	null
14 ו ו וכשאני conjunction unspecified unspecified unspecified unspecified unspecified 0 
14 כש כש וכשאני temporalSubConj unspecified unspecified unspecified unspecified unspecified 0 
14 אני הוא וכשאני pronoun masculine-and-feminine singular unspecified 1 unspecified  	O	null
15 לבד לבד לבד adverb unspecified unspecified unspecified unspecified unspecified  	O	null
16 אז אז אז conjunction unspecified unspecified unspecified unspecified unspecified  	O	null
17 כל כול כל quantifier unspecified unspecified construct unspecified unspecified  	O	null
18 ה ה החברים definiteArticle unspecified unspecified unspecified unspecified unspecified 0 
18 החברים חבר החברים noun masculine plural absolute unspecified unspecified  	O	null
19 באים בא באים verb masculine plural unspecified any beinoni  	O	null
20 אל אל אל preposition unspecified unspecified unspecified unspecified unspecified  	O	null
21 ה ה החלון definiteArticle unspecified unspecified unspecified unspecified unspecified 0 
21 החלון חילון החלון noun masculine singular absolute unspecified unspecified  	O	null
22 ו ו וצועקים conjunction unspecified unspecified unspecified unspecified unspecified 0 
22 צועקים צעק וצועקים verb masculine plural unspecified any beinoni  	O	null
23 ל ל לי preposition unspecified unspecified unspecified unspecified unspecified  
23 י י לי pronomial masculine-and-feminine singular unspecified 1 unspecified 0 	O	null
24 הופה הופה הופה noun masculine singular absolute unspecified unspecified  	O	null

0 הופה הופה הופה properName unspecified unspecified unspecified unspecified unspecified  	I_PERS	null
1 הופה הופה הופה properName unspecified unspecified unspecified unspecified unspecified  	I_PERS	null
2 הופה הופה הופה properName unspecified unspecified unspecified unspecified unspecified  	I_PERS	null
3 הופה הופה הופה properName unspecified unspecified unspecified unspecified unspecified  	I_PERS	null
4 היי הי היי interjection unspecified unspecified unspecified unspecified unspecified  	O	null
5 תשיר שר תשיר verb feminine singular unspecified 3 future  	O	null
6 את את איתנו at-preposition unspecified unspecified unspecified unspecified unspecified  
6 נו נו איתנו pronomial masculine-and-feminine plural unspecified 1 unspecified 0 	O	null
7 הופה הופה הופה properName unspecified unspecified unspecified unspecified unspecified  	I_PERS	null
8 הופה הופה הופה properName unspecified unspecified unspecified unspecified unspecified  	I_PERS	null
9 הופה הופה הופה properName unspecified unspecified unspecified unspecified unspecified  	I_PERS	null
10 היי הי היי interjection unspecified unspecified unspecified unspecified unspecified  	O	null
11 ו ו וכשאתה conjunction unspecified unspecified unspecified unspecified unspecified 0 
11 כש כש וכשאתה temporalSubConj unspecified unspecified unspecified unspecified unspecified 0 
11 אתה הוא וכשאתה pronoun masculine singular unspecified 2 unspecified  	O	null
12 עצוב עצוב עצוב adjective masculine singular absolute unspecified unspecified  	O	null
13 כל כול כל quantifier unspecified unspecified construct unspecified unspecified  	O	null
14 כך כך כך pronoun unspecified unspecified unspecified unspecified unspecified  	O	null
15 תמיד תמיד תמיד adverb unspecified unspecified unspecified unspecified unspecified  	O	null
16 ת'הופה ת'הופה ת'הופה properName unspecified unspecified unspecified unspecified unspecified  	I_PERS	null
17 אל אל אל negation unspecified unspecified unspecified unspecified unspecified  	O	null
18 תשכח שכח תשכח verb feminine singular unspecified 3 future  	O	null
19 תיקח לקח תיקח verb feminine singular unspecified 3 future  	O	null
20 את את איתך at-preposition unspecified unspecified unspecified unspecified unspecified  
20 ך ך איתך pronomial masculine singular unspecified 2 unspecified 0 	O	null
21 ת'הופה ת'הופה ת'הופה verb feminine singular unspecified any beinoni  	O	null
22 הופה הופה הופה properName unspecified unspecified unspecified unspecified unspecified  	I_PERS	null
23 הופה הופה הופה properName unspecified unspecified unspecified unspecified unspecified  	I_PERS	null
24 היי הי היי interjection unspecified unspecified unspecified unspecified unspecified  	O	null

0 אני הוא אני pronoun masculine-and-feminine singular unspecified 1 unspecified  	O	null
1 כל כול כל quantifier unspecified unspecified construct unspecified unspecified  	O	null
2 כך כך כך pronoun unspecified unspecified unspecified unspecified unspecified  	O	null
3 אוהב אהב אוהב verb masculine singular unspecified any beinoni  	O	null
4 ילדה ילד ילדה noun feminine singular absolute unspecified unspecified  	O	null
5 אחת CARD1 אחת numeral feminine singular absolute unspecified unspecified  	O	null
6 מ מ מהכיתה preposition unspecified unspecified unspecified unspecified unspecified 0 
6 ה ה מהכיתה definiteArticle unspecified unspecified unspecified unspecified unspecified 0 
6 הכיתה כיתה מהכיתה noun feminine singular absolute unspecified unspecified  	O	null
7 ו ו והיא conjunction unspecified unspecified unspecified unspecified unspecified 0 
7 היא הוא והיא pronoun feminine singular unspecified 3 unspecified  	O	null
8 שולחת שלח שולחת verb feminine singular unspecified any beinoni  	O	null
9 ל ל לי preposition unspecified unspecified unspecified unspecified unspecified  
9 י י לי pronomial masculine-and-feminine singular unspecified 1 unspecified 0 	O	null
10 עיניים עין עיניים noun feminine plural absolute unspecified unspecified  	O	null
11 בלי בלי בלי conjunction unspecified unspecified unspecified unspecified unspecified  	O	null
12 לומר אמר לומר verb unspecified unspecified unspecified unspecified infinitive  	O	null
13 ל ל לי preposition unspecified unspecified unspecified unspecified unspecified  
13 י י לי pronomial masculine-and-feminine singular unspecified 1 unspecified 0 	O	null
14 אף אף אף quantifier unspecified unspecified construct unspecified unspecified  	O	null
15 מילה מילה מילה noun feminine singular absolute unspecified unspecified  	O	null
16 אני הוא אני pronoun masculine-and-feminine singular unspecified 1 unspecified  	O	null
17 כל כול כל quantifier unspecified unspecified construct unspecified unspecified  	O	null
18 כך כך כך pronoun unspecified unspecified unspecified unspecified unspecified  	O	null
19 נרגש נרגש נרגש adjective masculine singular absolute unspecified unspecified  	O	null
20 ו ו וגם conjunction unspecified unspecified unspecified unspecified unspecified 0 
20 גם גם וגם conjunction unspecified unspecified unspecified unspecified unspecified  	O	null
21 קצת קצת קצת adverb unspecified unspecified unspecified unspecified unspecified  	O	null
22 מיואש מיואש מיואש adjective masculine singular absolute unspecified unspecified  	O	null
23 ו ו ואז conjunction unspecified unspecified unspecified unspecified unspecified 0 
23 אז אז ואז conjunction unspecified unspecified unspecified unspecified unspecified  	O	null
24 ה ה החברים definiteArticle unspecified unspecified unspecified unspecified unspecified 0 
24 החברים חבר החברים noun masculine plural absolute unspecified unspecified  	O	null
25 של של שלי shel-preposition unspecified unspecified unspecified unspecified unspecified  
25 י י שלי pronomial masculine-and-feminine singular unspecified 1 unspecified 0 	O	null
26 שרים שר שרים noun masculine plural absolute unspecified unspecified  	O	null
27 ל ל לי preposition unspecified unspecified unspecified unspecified unspecified  
27 י י לי pronomial masculine-and-feminine singular unspecified 1 unspecified 0 	O	null
28 הופה הופה הופה noun masculine singular absolute unspecified unspecified  	O	null

0 הופה הופה הופה properName unspecified unspecified unspecified unspecified unspecified  	I_PERS	null
1 הופה הופה הופה properName unspecified unspecified unspecified unspecified unspecified  	I_PERS	null
2 הופה... הופה... הופה... verb feminine singular unspecified any beinoni  	O	null

0 אני הוא אני pronoun masculine-and-feminine singular unspecified 1 unspecified  	O	null
1 יושב ישב יושב verb masculine singular unspecified any beinoni  	O	null
2 ל ל לי preposition unspecified unspecified unspecified unspecified unspecified  
2 י י לי pronomial masculine-and-feminine singular unspecified 1 unspecified 0 	O	null
3 ו ו וחושב conjunction unspecified unspecified unspecified unspecified unspecified 0 
3 חושב חשב וחושב verb masculine singular unspecified any beinoni  	O	null
4 איך איך איך adverb unspecified unspecified unspecified unspecified unspecified  	O	null
5 ה ה הימים definiteArticle unspecified unspecified unspecified unspecified unspecified 0 
5 הימים יום הימים noun masculine plural absolute unspecified unspecified  	O	null
6 חולפים חלף חולפים verb masculine plural unspecified any beinoni  	O	null
7 ו ו ובלי conjunction unspecified unspecified unspecified unspecified unspecified 0 
7 בלי בלי ובלי conjunction unspecified unspecified unspecified unspecified unspecified  	O	null
8 ההופה ההופה ההופה verb masculine singular unspecified 2 imperative  	O	null
9 לא לא לא negation unspecified unspecified unspecified unspecified unspecified  	O	null
10 היו הוא היו copula masculine plural unspecified 2 imperative  	O	null
11 ל ל לי preposition unspecified unspecified unspecified unspecified unspecified  
11 י י לי pronomial masculine-and-feminine singular unspecified 1 unspecified 0 	O	null
12 חברים חבר חברים noun masculine plural absolute unspecified unspecified  	O	null
13 כל כול כל quantifier unspecified unspecified construct unspecified unspecified  	O	null
14 כך כך כך pronoun unspecified unspecified unspecified unspecified unspecified  	O	null
15 טובים טוב טובים adjective masculine plural absolute unspecified unspecified  	O	null
16 תמיד תמיד תמיד adverb unspecified unspecified unspecified unspecified unspecified  	O	null
17 זה זה זה pronoun masculine singular unspecified 3 unspecified  	O	null
18 ל ל לי preposition unspecified unspecified unspecified unspecified unspecified  
18 י י לי pronomial masculine-and-feminine singular unspecified 1 unspecified 0 	O	null
19 עזר עזר עזר verb masculine singular unspecified 3 past  	O	null
20 את את אותו at-preposition unspecified unspecified unspecified unspecified unspecified  
20 ו ו אותו pronomial masculine singular unspecified 3 unspecified 0 	O	null
21 פזמון פזמון פזמון noun masculine singular absolute unspecified unspecified  	O	null
22 מוכר מוכר מוכר adjective masculine singular absolute unspecified unspecified  	O	null
23 נסו נס נסו verb masculine-and-feminine plural unspecified 3 past  	O	null
24 את את אתם at-preposition unspecified unspecified unspecified unspecified unspecified  
24 הם הם אתם pronomial masculine plural unspecified 3 unspecified 0 	O	null
25 את את איתי at-preposition unspecified unspecified unspecified unspecified unspecified  
25 י י איתי pronomial masculine-and-feminine singular unspecified 1 unspecified 0 	O	null
26 את את את at-preposition unspecified unspecified unspecified unspecified unspecified  	O	null
27 ה ה המילים definiteArticle unspecified unspecified unspecified unspecified unspecified 0 
27 המילים מילה המילים noun feminine plural absolute unspecified unspecified  	O	null
28 ו ו והופה conjunction unspecified unspecified unspecified unspecified unspecified 0 
28 הופה הופה והופה noun masculine singular absolute unspecified unspecified  	O	null

0 הופה הופה הופה properName unspecified unspecified unspecified unspecified unspecified  	I_PERS	null
1 הופה הופה הופה properName unspecified unspecified unspecified unspecified unspecified  	I_PERS	null
2 הופה... הופה... הופה... verb feminine singular unspecified any beinoni  	O	null

