0 ב ב בימים preposition unspecified unspecified unspecified unspecified unspecified 0 
0 ימים יום בימים noun masculine plural absolute unspecified unspecified  	O	null
1 שקוסוביצקי שקוסוביצקי שקוסוביצקי adjective masculine plural construct unspecified unspecified  	O	null
2 ה ה המנצח definiteArticle unspecified unspecified unspecified unspecified unspecified 0 
2 המנצח מנצח המנצח noun masculine singular absolute unspecified unspecified  	O	null
3 ה ה הגאון definiteArticle unspecified unspecified unspecified unspecified unspecified 0 
3 הגאון גאון הגאון noun masculine singular absolute unspecified unspecified  	O	null
4 לא לא לא negation unspecified unspecified unspecified unspecified unspecified  	O	null
5 ידע ידע ידע verb masculine singular unspecified 3 past  	O	null
6 לקרוא קרא לקרוא verb unspecified unspecified unspecified unspecified infinitive  	O	null
7 תווים תו תווים noun masculine plural absolute unspecified unspecified  	O	null
8 בלי בלי בלי preposition unspecified unspecified unspecified unspecified unspecified  	O	null
9 נקודות נקודה נקודות noun feminine plural absolute unspecified unspecified  	O	null
10 בא בא בא verb masculine singular unspecified 3 past  	O	null
11 ל ל לארץ preposition unspecified unspecified unspecified unspecified unspecified 0 
11 ארץ ארץ לארץ noun feminine singular construct unspecified unspecified  	O	null
12 אוסוביצקי אוסוביצקי אוסוביצקי properName unspecified unspecified unspecified unspecified unspecified  	O	null
13 ה ה המזכיר definiteArticle unspecified unspecified unspecified unspecified unspecified 0 
13 המזכיר מזכיר המזכיר noun masculine singular absolute unspecified unspecified  	O	null
14 של של של shel-preposition unspecified unspecified unspecified unspecified unspecified  	O	null
15 ה ה הברון definiteArticle unspecified unspecified unspecified unspecified unspecified 0 
15 הברון ברון הברון noun masculine singular absolute unspecified unspecified  	O	null
16 ו ו ואמר conjunction unspecified unspecified unspecified unspecified unspecified 0 
16 אמר אמר ואמר verb masculine singular unspecified 3 past  	O	null
17 ל ל לפריימן preposition unspecified unspecified unspecified unspecified unspecified 0 
17 פריימן פריימן לפריימן properName unspecified unspecified unspecified unspecified unspecified  	I_PERS	null
18 קים קים קים properName unspecified unspecified unspecified unspecified unspecified  	I_PERS	null
19 ואורכסטרה ואורכסטרה ואורכסטרה properName unspecified unspecified unspecified unspecified unspecified  	I_PERS	null
20 פה פה פה adverb unspecified unspecified unspecified unspecified unspecified  	O	null
21 נקים הקים נקים verb masculine-and-feminine plural unspecified 1 future  	O	null
22 מאירוביץ מאירוביץ מאירוביץ properName unspecified unspecified unspecified unspecified unspecified  	I_PERS	null
23 בא בא בא verb masculine singular unspecified 3 past  	O	null
24 עם עם עם preposition unspecified unspecified unspecified unspecified unspecified  	O	null
25 פיילה פיילה פיילה noun feminine singular absolute unspecified unspecified  	O	null
26 חיסין חיסין חיסין properName unspecified unspecified unspecified unspecified unspecified  	I_PERS	null
27 בא בא בא verb masculine singular unspecified 3 past  	O	null
28 עם עם עם preposition unspecified unspecified unspecified unspecified unspecified  	O	null
29 תוף תוף תוף noun masculine singular absolute unspecified unspecified  	O	null
30 מ מ מעור preposition unspecified unspecified unspecified unspecified unspecified 0 
30 עור עור מעור noun masculine singular construct unspecified unspecified  	O	null
31 גיסין גיסין גיסין properName unspecified unspecified unspecified unspecified unspecified  	I_PERS	null
32 בא בא בא verb masculine singular unspecified 3 past  	O	null
33 לו לו לו conjunction unspecified unspecified unspecified unspecified unspecified  	O	null
34 עם עם עם preposition unspecified unspecified unspecified unspecified unspecified  	O	null
35 אשת איש אשתו noun feminine singular absolute unspecified unspecified  
35 ו ו אשתו possessive masculine singular unspecified 3 unspecified 0 	O	null
36 של של של shel-preposition unspecified unspecified unspecified unspecified unspecified  	O	null
37 מוישה מוישה מוישה noun masculine plural construct unspecified unspecified  	O	null
38 נט נט נט properName unspecified unspecified unspecified unspecified unspecified  	I_ORG	null
39 ו ו ואפילו conjunction unspecified unspecified unspecified unspecified unspecified 0 
39 אפילו אפילו ואפילו conjunction unspecified unspecified unspecified unspecified unspecified  	O	null
40 מוישה מוישה מוישה noun masculine plural construct unspecified unspecified  	O	null
41 זיילר זיילר זיילר properName unspecified unspecified unspecified unspecified unspecified  	I_LOC	null
42 עם עם עם preposition unspecified unspecified unspecified unspecified unspecified  	I_LOC	null
43 מיתר מיתר מיתר properName unspecified unspecified unspecified unspecified unspecified  	I_LOC	null
44 אך אך אך conjunction unspecified unspecified unspecified unspecified unspecified  	O	null
45 בלי בלי בלי preposition unspecified unspecified unspecified unspecified unspecified  	O	null
46 כינור כינור כינור noun masculine singular absolute unspecified unspecified  	O	null
47 ו ו ומאסטרו conjunction unspecified unspecified unspecified unspecified unspecified 0 
47 מאסטרו מאסטרו ומאסטרו noun masculine singular construct unspecified unspecified  	O	null
48 אוסוביץ אוסוביץ אוסוביץ properName unspecified unspecified unspecified unspecified unspecified  	I_ORG	null
49 אז אז אז conjunction unspecified unspecified unspecified unspecified unspecified  	O	null
50 הרים הרים הרים verb masculine singular unspecified 3 past  	O	null
51 את את את at-preposition unspecified unspecified unspecified unspecified unspecified  	O	null
52 ה ה השרביץ definiteArticle unspecified unspecified unspecified unspecified unspecified 0 
52 השרביץ השרביץ השרביץ participle masculine plural absolute any unspecified  	O	null
53 . . . punctuation unspecified unspecified unspecified unspecified unspecified  	O	null

0 ו ו ו conjunction unspecified unspecified unspecified unspecified unspecified  	O	null
1 ... ... ... punctuation unspecified unspecified unspecified unspecified unspecified  	O	null
2 ו ו ו conjunction unspecified unspecified unspecified unspecified unspecified  	O	null
3 ... ... ... punctuation unspecified unspecified unspecified unspecified unspecified  	O	null
4 איזה איזה איזה interrogative unspecified unspecified unspecified unspecified unspecified  	O	null
5 אורכסטרה אורכסטרה אורכסטרה properName unspecified unspecified unspecified unspecified unspecified  	I_LOC	null
6 איזה איזה איזה quantifier unspecified unspecified construct unspecified unspecified  	O	null
7 אורכסטרה אורכסטרה אורכסטרה properName unspecified unspecified unspecified unspecified unspecified  	I_PERS	null
8 יפה יפה יפה properName unspecified unspecified unspecified unspecified unspecified  	I_PERS	null
9 , , , punctuation unspecified unspecified unspecified unspecified unspecified  	O	null
10 ה ה המנגנים definiteArticle unspecified unspecified unspecified unspecified unspecified 0 
10 המנגנים ניגן המנגנים participle masculine plural absolute any unspecified  	O	null
11 דבר דבר דברו noun masculine singular absolute unspecified unspecified  
11 ו ו דברו possessive masculine singular unspecified 3 unspecified 0 	O	null
12 רוסית רוסי רוסית adjective feminine singular absolute unspecified unspecified  	O	null
13 אבל אבל אבל conjunction unspecified unspecified unspecified unspecified unspecified  	O	null
14 זייפו זייף זייפו verb masculine-and-feminine plural unspecified 3 past  	O	null
15 רק רק רק adverb unspecified unspecified unspecified unspecified unspecified  	O	null
16 ב ב בעברית preposition unspecified unspecified unspecified unspecified unspecified 0 
16 עברית עברית בעברית properName feminine singular unspecified unspecified unspecified  	O	null
17 איזה איזה איזה quantifier unspecified unspecified construct unspecified unspecified  	I_MONEY	null
18 אורכסטרה אורכסטרה אורכסטרה properName unspecified unspecified unspecified unspecified unspecified  	O	null
19 ראשון ORD1 ראשון numeral masculine singular absolute unspecified unspecified  	I_DATE	null
20 ל ל לציון preposition unspecified unspecified unspecified unspecified unspecified 0 
20 ציון ציון לציון properName unspecified unspecified unspecified unspecified unspecified  	I_LOC	null
21 מארש מארש מארש properName unspecified unspecified unspecified unspecified unspecified  	I_LOC	null
22 . . . punctuation unspecified unspecified unspecified unspecified unspecified  	O	null

0 היא הוא היא pronoun feminine singular unspecified 3 unspecified  	O	null
1 נגנה ניגן נגנה verb feminine singular unspecified 3 past  	O	null
2 ב ב בשער preposition unspecified unspecified unspecified unspecified unspecified 0 
2 ה ה בשער definiteArticle unspecified unspecified unspecified unspecified unspecified 0 
2 השער שער בשער noun masculine singular absolute unspecified unspecified  	O	null
3 מקווה קיווה מקווה verb masculine singular unspecified any beinoni  	O	null
4 ש ש שאו relativizer/subordinatingConjunction unspecified unspecified unspecified unspecified unspecified 0 
4 או או שאו conjunction unspecified unspecified unspecified unspecified unspecified  	O	null
5 ציונה ציונה ציונה properName feminine singular unspecified unspecified unspecified  	I_PERS	null
6 נס נס נס verb masculine singular unspecified 3 past  	I_PERS	null
7 ציון ציון ציון properName unspecified unspecified unspecified unspecified unspecified  	I_PERS	null
8 היא הוא היא pronoun feminine singular unspecified 3 unspecified  	O	null
9 נסעה נסע נסעה verb feminine singular unspecified 3 past  	O	null
10 ל ל לנס preposition unspecified unspecified unspecified unspecified unspecified 0 
10 נס נס לנס noun masculine singular construct unspecified unspecified  	I_LOC	null
11 ציונה ציונה ציונה properName unspecified unspecified unspecified unspecified unspecified  	I_LOC	null
12 ל ל לקונצרט preposition unspecified unspecified unspecified unspecified unspecified 0 
12 ה ה לקונצרט definiteArticle unspecified unspecified unspecified unspecified unspecified 0 
12 הקונצרט קונצרט לקונצרט noun masculine singular absolute unspecified unspecified  	O	null
13 היא הוא היא pronoun feminine singular unspecified 3 unspecified  	O	null
14 נגנה ניגן נגנה verb feminine singular unspecified 3 past  	O	null
15 ב ב בפתח preposition unspecified unspecified unspecified unspecified unspecified 0 
15 פתח פתח בפתח noun masculine singular construct unspecified unspecified  	I_LOC	null
16 תקווה תקווה תקווה properName unspecified unspecified unspecified unspecified unspecified  	I_LOC	null
17 ו ו וכשבא conjunction unspecified unspecified unspecified unspecified unspecified 0 
17 כש כש וכשבא temporalSubConj unspecified unspecified unspecified unspecified unspecified 0 
17 בא בא וכשבא verb masculine singular unspecified 3 past  	O	null
18 כבוד כבוד כבוד noun masculine singular construct unspecified unspecified  	O	null
19 ה ה הברון definiteArticle unspecified unspecified unspecified unspecified unspecified 0 
19 הברון ברון הברון noun masculine singular absolute unspecified unspecified  	O	null
20 היא הוא היא pronoun feminine singular unspecified 3 unspecified  	O	null
21 נגנה ניגן נגנה verb feminine singular unspecified 3 past  	O	null
22 ל ל לו preposition unspecified unspecified unspecified unspecified unspecified  
22 ו ו לו pronomial masculine singular unspecified 3 unspecified 0 	O	null
23 ב ב בשמחה preposition unspecified unspecified unspecified unspecified unspecified 0 
23 שמחה שמחה בשמחה noun feminine singular absolute unspecified unspecified  	O	null
24 ו ו והוא conjunction unspecified unspecified unspecified unspecified unspecified 0 
24 הוא הוא והוא pronoun masculine singular unspecified 3 unspecified  	O	null
25 הפסיק הפסיק הפסיק verb masculine singular unspecified 3 past  	O	null
26 את את את at-preposition unspecified unspecified unspecified unspecified unspecified  	O	null
27 ה ה התמיכה definiteArticle unspecified unspecified unspecified unspecified unspecified 0 
27 התמיכה תמיכה התמיכה noun feminine singular absolute unspecified unspecified  	O	null

0 ו ו ו conjunction unspecified unspecified unspecified unspecified unspecified  	O	null
1 ... ... ... punctuation unspecified unspecified unspecified unspecified unspecified  	O	null
2 ו ו ו conjunction unspecified unspecified unspecified unspecified unspecified  	O	null
3 ... ... ... punctuation unspecified unspecified unspecified unspecified unspecified  	O	null
4 איזה איזה איזה interrogative unspecified unspecified unspecified unspecified unspecified  	O	null
5 אורכסטרה אורכסטרה אורכסטרה properName unspecified unspecified unspecified unspecified unspecified  	I_PERS	null
6 ... ... ... punctuation unspecified unspecified unspecified unspecified unspecified  	O	null

0 ב ב בחגים preposition unspecified unspecified unspecified unspecified unspecified 0 
0 ה ה בחגים definiteArticle unspecified unspecified unspecified unspecified unspecified 0 
0 החגים חג בחגים noun masculine plural absolute unspecified unspecified  	O	null
1 עם עם עם preposition unspecified unspecified unspecified unspecified unspecified  	O	null
2 רדת רדת רדת noun masculine singular construct unspecified unspecified  	O	null
3 ליל ליל ליל noun masculine singular absolute unspecified unspecified  	O	null
4 היא הוא היא pronoun feminine singular unspecified 3 unspecified  	O	null
5 יצאה יצא יצאה verb feminine singular unspecified 3 past  	O	null
6 אל אל אל preposition unspecified unspecified unspecified unspecified unspecified  	O	null
7 ה ה החולות definiteArticle unspecified unspecified unspecified unspecified unspecified 0 
7 החולות חול החולות noun masculine plural absolute unspecified unspecified  	O	null
8 לנגן ניגן לנגן verb unspecified unspecified unspecified unspecified infinitive  	O	null
9 ב ב באור preposition unspecified unspecified unspecified unspecified unspecified 0 
9 אור אור באור noun masculine singular construct unspecified unspecified  	O	null
10 ירח ירח ירח noun masculine singular absolute unspecified unspecified  	O	null
11 קראקוביאק קראקוביאק קראקוביאק properName unspecified unspecified unspecified unspecified unspecified  	I_PERS	null
12 ו ו ויצאו conjunction unspecified unspecified unspecified unspecified unspecified 0 
12 יצאו יצא ויצאו verb masculine-and-feminine plural unspecified 3 past  	O	null
13 ב ב במחול preposition unspecified unspecified unspecified unspecified unspecified 0 
13 מחול מחול במחול noun masculine singular construct unspecified unspecified  	O	null
14 מחניים מחניים מחניים properName masculine singular unspecified unspecified unspecified  	O	null
15 ב ב בחורים preposition unspecified unspecified unspecified unspecified unspecified 0 
15 חורים חור בחורים noun masculine plural absolute unspecified unspecified  	O	null
16 ו ו ובתולות conjunction unspecified unspecified unspecified unspecified unspecified 0 
16 בתולות בתולה ובתולות noun feminine plural absolute unspecified unspecified  	O	null
17 ב ב בילויות preposition unspecified unspecified unspecified unspecified unspecified 0 
17 ילויות ילויות בילויות adjective feminine plural construct unspecified unspecified  	O	null
18 ו ו ובילויים conjunction unspecified unspecified unspecified unspecified unspecified 0 
18 בילויים בילוי ובילויים noun masculine plural absolute unspecified unspecified  	O	null
19 ו ו והלכו conjunction unspecified unspecified unspecified unspecified unspecified 0 
19 הלכו הלך והלכו verb masculine-and-feminine plural unspecified 3 past  	O	null
20 שם שם שם adverb unspecified unspecified unspecified unspecified unspecified  	O	null
21 בילויים בילוי בילויים noun masculine plural absolute unspecified unspecified  	O	null
22 . . . punctuation unspecified unspecified unspecified unspecified unspecified  	O	null

0 ו ו ובליל conjunction unspecified unspecified unspecified unspecified unspecified 0 
0 ב ב ובליל preposition unspecified unspecified unspecified unspecified unspecified 0 
0 ליל ליל ובליל noun masculine singular absolute unspecified unspecified  	O	null
1 שישי ORD6 שישי numeral masculine singular absolute unspecified unspecified  	O	null
2 ב ב בערב preposition unspecified unspecified unspecified unspecified unspecified 0 
2 ערב ערב בערב noun masculine singular construct unspecified unspecified  	O	null
3 ריקודים ריקוד ריקודים noun masculine plural absolute unspecified unspecified  	O	null
4 ב ב בבית preposition unspecified unspecified unspecified unspecified unspecified 0 
4 בית בית בבית noun masculine singular construct unspecified unspecified  	O	null
5 ה ה העם definiteArticle unspecified unspecified unspecified unspecified unspecified 0 
5 העם עם העם noun masculine singular absolute unspecified unspecified  	O	null
6 אבל אבל אבל conjunction unspecified unspecified unspecified unspecified unspecified  	O	null
7 סבא סבא סבא noun masculine singular absolute unspecified unspecified  	O	null
8 ו ו וגם conjunction unspecified unspecified unspecified unspecified unspecified 0 
8 גם גם וגם conjunction unspecified unspecified unspecified unspecified unspecified  	O	null
9 סבתא סבא סבתא noun feminine singular absolute unspecified unspecified  	O	null
10 לא לא לא negation unspecified unspecified unspecified unspecified unspecified  	O	null
11 רקדו רקד רקדו verb masculine-and-feminine plural unspecified 3 past  	O	null
12 ב ב בפרדס preposition unspecified unspecified unspecified unspecified unspecified 0 
12 פרדס פרדס בפרדס noun masculine singular absolute unspecified unspecified  	O	null
13 על על על preposition unspecified unspecified unspecified unspecified unspecified  	O	null
14 יד יד יד noun feminine singular construct unspecified unspecified  	O	null
15 ה ה היקב definiteArticle unspecified unspecified unspecified unspecified unspecified 0 
15 היקב יקב היקב noun masculine singular absolute unspecified unspecified  	O	null
16 הם הוא הם pronoun masculine plural unspecified 3 unspecified  	O	null
17 ישבו ישב ישבו verb masculine-and-feminine plural unspecified 3 past  	O	null
18 ב ב בלב preposition unspecified unspecified unspecified unspecified unspecified 0 
18 לב לב בלב noun masculine singular absolute unspecified unspecified  	O	null
19 נפעם נפעם נפעם verb masculine singular unspecified any beinoni  	O	null
20 ו ו ושרקו conjunction unspecified unspecified unspecified unspecified unspecified 0 
20 שרקו שרק ושרקו verb masculine-and-feminine plural unspecified 3 past  	O	null
21 את את את at-preposition unspecified unspecified unspecified unspecified unspecified  	O	null
22 ה ה המזמור definiteArticle unspecified unspecified unspecified unspecified unspecified 0 
22 המזמור מזמור המזמור noun masculine singular absolute unspecified unspecified  	O	null
23 ב ב במבטא preposition unspecified unspecified unspecified unspecified unspecified 0 
23 מבטא מבטא במבטא noun masculine singular absolute unspecified unspecified  	O	null
24 רוסי רוסי רוסי adjective masculine singular absolute unspecified unspecified  	O	null
25 טהור טהור טהור adjective masculine singular absolute unspecified unspecified  	O	null
26 . . . punctuation unspecified unspecified unspecified unspecified unspecified  	O	null

0 איזה איזה איזה quantifier unspecified unspecified construct unspecified unspecified  	O	null
1 אורכסטרה... אורכסטרה... אורכסטרה... properName unspecified unspecified unspecified unspecified unspecified  	O	null

