0 ה ה הלילה definiteArticle unspecified unspecified unspecified unspecified unspecified 0 
0 הלילה לילה הלילה noun masculine singular absolute unspecified unspecified  	O	null
1 הוא הוא הוא pronoun masculine singular unspecified 3 unspecified  	O	null
2 יבוא ייבוא יבוא noun masculine singular construct unspecified unspecified  	O	null
3 הלל הילל הלל properName unspecified unspecified unspecified unspecified unspecified  	I_PERS	null
4 יה יה יה properName unspecified unspecified unspecified unspecified unspecified  	I_PERS	null
5 , , , punctuation unspecified unspecified unspecified unspecified unspecified  	O	null
6 לל לל לל properName unspecified unspecified unspecified unspecified unspecified  	I_PERS	null
7 יה יה יה properName unspecified unspecified unspecified unspecified unspecified  	I_PERS	null
8 , , , punctuation unspecified unspecified unspecified unspecified unspecified  	O	null
9 אודה הודה אודה verb masculine-and-feminine singular unspecified 1 future  	O	null
10 ליה ליה ליה properName unspecified unspecified unspecified unspecified unspecified  	I_PERS	null
11 ה ה הלילה definiteArticle unspecified unspecified unspecified unspecified unspecified 0 
11 הלילה לילה הלילה noun masculine singular absolute unspecified unspecified  	O	null
12 ה ה הלילה definiteArticle unspecified unspecified unspecified unspecified unspecified 0 
12 הלילה לילה הלילה noun masculine singular absolute unspecified unspecified  	O	null
13 הנה הוא הנה copula feminine singular unspecified 3 beinoni  	O	null
14 זה זה זה pronoun masculine singular unspecified 3 unspecified  	O	null
15 בא בא בא verb masculine singular unspecified 3 past  	O	null
16 . . . punctuation unspecified unspecified unspecified unspecified unspecified  	O	null

0 גלה גלה גלה verb masculine singular unspecified 3 past  	O	null
1 ל ל לי preposition unspecified unspecified unspecified unspecified unspecified  
1 י י לי pronomial masculine-and-feminine singular unspecified 1 unspecified 0 	O	null
2 את את את at-preposition unspecified unspecified unspecified unspecified unspecified  	O	null
3 שמחתי שמח שמחתי verb masculine-and-feminine singular unspecified 1 past  	I_ORG	null
4 בוא בא בוא verb masculine singular unspecified 2 imperative  	O	null
5 , , , punctuation unspecified unspecified unspecified unspecified unspecified  	O	null
6 גלה גלה גלה verb masculine singular unspecified 3 past  	O	null
7 ל ל לי preposition unspecified unspecified unspecified unspecified unspecified  
7 י י לי pronomial masculine-and-feminine singular unspecified 1 unspecified 0 	O	null
8 ניצוץ ניצוץ ניצוץ noun masculine singular absolute unspecified unspecified  	O	null
9 של של של shel-preposition unspecified unspecified unspecified unspecified unspecified  	O	null
10 נחמה נחמה נחמה properName unspecified unspecified unspecified unspecified unspecified  	I_PERS	null
11 ב ב בי preposition unspecified unspecified unspecified unspecified unspecified  
11 י י בי pronomial masculine-and-feminine singular unspecified 1 unspecified 0 	O	null
12 . . . punctuation unspecified unspecified unspecified unspecified unspecified  	O	null

0 ה ה הלילה definiteArticle unspecified unspecified unspecified unspecified unspecified 0 
0 הלילה לילה הלילה noun masculine singular absolute unspecified unspecified  	O	null
1 הוא הוא הוא pronoun masculine singular unspecified 3 unspecified  	O	null
2 יבוא.. יבוא.. יבוא.. verb masculine singular unspecified 2 future  	O	null

0 הללו הללו הללו pronoun masculine plural unspecified 3 unspecified  	O	null
1 יה יה יה properName unspecified unspecified unspecified unspecified unspecified  	I_PERS	null
2 כי כי כי conjunction unspecified unspecified unspecified unspecified unspecified  	O	null
3 טוב טוב טוב interjection unspecified unspecified unspecified unspecified unspecified  	O	null
4 כי כי כי conjunction unspecified unspecified unspecified unspecified unspecified  	O	null
5 לעולם לעולם לעולם adverb unspecified unspecified unspecified unspecified unspecified  	O	null
6 חסד חסד חסדו noun masculine singular absolute unspecified unspecified  
6 ו ו חסדו possessive masculine singular unspecified 3 unspecified 0 	O	null
7 . . . punctuation unspecified unspecified unspecified unspecified unspecified  	O	null

