0 Never Never Never foreign unspecified unspecified unspecified unspecified unspecified  	I_ORG	null
1 trust trust trust foreign unspecified unspecified unspecified unspecified unspecified  	I_ORG	null
2 a a a foreign unspecified unspecified unspecified unspecified unspecified  	I_ORG	null
3 white white white foreign unspecified unspecified unspecified unspecified unspecified  	I_ORG	null
4 man man man foreign unspecified unspecified unspecified unspecified unspecified  	I_ORG	null
5 , , , punctuation unspecified unspecified unspecified unspecified unspecified  	O	null
6 Never Never Never foreign unspecified unspecified unspecified unspecified unspecified  	O	null
7 kill kill kill foreign unspecified unspecified unspecified unspecified unspecified  	O	null
8 a a a foreign unspecified unspecified unspecified unspecified unspecified  	O	null
9 Jew Jew Jew foreign unspecified unspecified unspecified unspecified unspecified  	O	null
10 , , , punctuation unspecified unspecified unspecified unspecified unspecified  	O	null
11 Never Never Never foreign unspecified unspecified unspecified unspecified unspecified  	O	null
12 sign sign sign foreign unspecified unspecified unspecified unspecified unspecified  	O	null
13 a a a foreign unspecified unspecified unspecified unspecified unspecified  	O	null
14 contract contract contract foreign unspecified unspecified unspecified unspecified unspecified  	O	null
15 , , , punctuation unspecified unspecified unspecified unspecified unspecified  	O	null
16 Never Never Never foreign unspecified unspecified unspecified unspecified unspecified  	O	null
17 rent rent rent foreign unspecified unspecified unspecified unspecified unspecified  	O	null
18 a a a foreign unspecified unspecified unspecified unspecified unspecified  	O	null
19 pew pew pew foreign unspecified unspecified unspecified unspecified unspecified  	O	null
20 . . . punctuation unspecified unspecified unspecified unspecified unspecified  	O	null

0 Don Don Don foreign unspecified unspecified unspecified unspecified unspecified  	O	null
1 ' ' ' punctuation unspecified unspecified unspecified unspecified unspecified  	O	null
2 t t t foreign unspecified unspecified unspecified unspecified unspecified  	I_ORG	null
3 enlist enlist enlist foreign unspecified unspecified unspecified unspecified unspecified  	I_ORG	null
4 in in in foreign unspecified unspecified unspecified unspecified unspecified  	I_ORG	null
5 armies armies armies foreign unspecified unspecified unspecified unspecified unspecified  	I_ORG	null
6 ; ; ; punctuation unspecified unspecified unspecified unspecified unspecified  	O	null
7 Nor Nor Nor foreign unspecified unspecified unspecified unspecified unspecified  	O	null
8 marry marry marry foreign unspecified unspecified unspecified unspecified unspecified  	O	null
9 many many many foreign unspecified unspecified unspecified unspecified unspecified  	O	null
10 wives wives wives foreign unspecified unspecified unspecified unspecified unspecified  	O	null
11 ; ; ; punctuation unspecified unspecified unspecified unspecified unspecified  	O	null
12 Never Never Never foreign unspecified unspecified unspecified unspecified unspecified  	O	null
13 write write write foreign unspecified unspecified unspecified unspecified unspecified  	O	null
14 for for for foreign unspecified unspecified unspecified unspecified unspecified  	O	null
15 magazines magazines magazines foreign unspecified unspecified unspecified unspecified unspecified  	O	null
16 ; ; ; punctuation unspecified unspecified unspecified unspecified unspecified  	O	null
17 Never Never Never foreign unspecified unspecified unspecified unspecified unspecified  	O	null
18 scratch scratch scratch foreign unspecified unspecified unspecified unspecified unspecified  	O	null
19 your your your foreign unspecified unspecified unspecified unspecified unspecified  	O	null
20 hives hives hives foreign unspecified unspecified unspecified unspecified unspecified  	O	null
21 . . . punctuation unspecified unspecified unspecified unspecified unspecified  	O	null

0 Always Always Always foreign unspecified unspecified unspecified unspecified unspecified  	I_ORG	null
1 put put put foreign unspecified unspecified unspecified unspecified unspecified  	I_ORG	null
2 paper paper paper foreign unspecified unspecified unspecified unspecified unspecified  	I_ORG	null
3 on on on foreign unspecified unspecified unspecified unspecified unspecified  	I_ORG	null
4 the the the foreign unspecified unspecified unspecified unspecified unspecified  	I_ORG	null
5 seat seat seat foreign unspecified unspecified unspecified unspecified unspecified  	I_ORG	null
6 , , , punctuation unspecified unspecified unspecified unspecified unspecified  	O	null
7 Don Don Don foreign unspecified unspecified unspecified unspecified unspecified  	O	null
8 ' ' ' punctuation unspecified unspecified unspecified unspecified unspecified  	O	null
9 t t t foreign unspecified unspecified unspecified unspecified unspecified  	O	null
10 believe believe believe foreign unspecified unspecified unspecified unspecified unspecified  	O	null
11 in in in foreign unspecified unspecified unspecified unspecified unspecified  	O	null
12 wars wars wars foreign unspecified unspecified unspecified unspecified unspecified  	O	null
13 , , , punctuation unspecified unspecified unspecified unspecified unspecified  	O	null
14 Keep Keep Keep foreign unspecified unspecified unspecified unspecified unspecified  	I_ORG	null
15 yourself yourself yourself foreign unspecified unspecified unspecified unspecified unspecified  	I_ORG	null
16 both both both foreign unspecified unspecified unspecified unspecified unspecified  	I_ORG	null
17 clean clean clean foreign unspecified unspecified unspecified unspecified unspecified  	I_ORG	null
18 and and and foreign unspecified unspecified unspecified unspecified unspecified  	I_ORG	null
19 neat neat neat foreign unspecified unspecified unspecified unspecified unspecified  	I_ORG	null
20 , , , punctuation unspecified unspecified unspecified unspecified unspecified  	O	null
21 Never Never Never foreign unspecified unspecified unspecified unspecified unspecified  	O	null
22 marry marry marry foreign unspecified unspecified unspecified unspecified unspecified  	O	null
23 whores whores whores foreign unspecified unspecified unspecified unspecified unspecified  	O	null
24 . . . punctuation unspecified unspecified unspecified unspecified unspecified  	O	null

0 Never Never Never foreign unspecified unspecified unspecified unspecified unspecified  	I_ORG	null
1 pay pay pay foreign unspecified unspecified unspecified unspecified unspecified  	I_ORG	null
2 a a a foreign unspecified unspecified unspecified unspecified unspecified  	I_ORG	null
3 blackmailer blackmailer blackmailer foreign unspecified unspecified unspecified unspecified unspecified  	I_ORG	null
4 , , , punctuation unspecified unspecified unspecified unspecified unspecified  	O	null
5 Never Never Never foreign unspecified unspecified unspecified unspecified unspecified  	O	null
6 go go go foreign unspecified unspecified unspecified unspecified unspecified  	O	null
7 to to to foreign unspecified unspecified unspecified unspecified unspecified  	O	null
8 law law law foreign unspecified unspecified unspecified unspecified unspecified  	O	null
9 , , , punctuation unspecified unspecified unspecified unspecified unspecified  	O	null
10 Never Never Never foreign unspecified unspecified unspecified unspecified unspecified  	O	null
11 trust trust trust foreign unspecified unspecified unspecified unspecified unspecified  	O	null
12 a a a foreign unspecified unspecified unspecified unspecified unspecified  	O	null
13 publisher publisher publisher foreign unspecified unspecified unspecified unspecified unspecified  	O	null
14 , , , punctuation unspecified unspecified unspecified unspecified unspecified  	O	null
15 Or Or Or foreign unspecified unspecified unspecified unspecified unspecified  	I_ORG	null
16 you'll you'll you'll foreign unspecified unspecified unspecified unspecified unspecified  	I_ORG	null
17 sleep sleep sleep foreign unspecified unspecified unspecified unspecified unspecified  	I_ORG	null
18 on on on foreign unspecified unspecified unspecified unspecified unspecified  	I_ORG	null
19 straw straw straw foreign unspecified unspecified unspecified unspecified unspecified  	I_ORG	null
20 . . . punctuation unspecified unspecified unspecified unspecified unspecified  	O	null

0 All All All foreign unspecified unspecified unspecified unspecified unspecified  	I_ORG	null
1 your your your foreign unspecified unspecified unspecified unspecified unspecified  	I_ORG	null
2 friends friends friends foreign unspecified unspecified unspecified unspecified unspecified  	I_ORG	null
3 will will will foreign unspecified unspecified unspecified unspecified unspecified  	I_ORG	null
4 leave leave leave foreign unspecified unspecified unspecified unspecified unspecified  	I_ORG	null
5 you you you foreign unspecified unspecified unspecified unspecified unspecified  	I_ORG	null
6 All All All foreign unspecified unspecified unspecified unspecified unspecified  	I_ORG	null
7 your your your foreign unspecified unspecified unspecified unspecified unspecified  	I_ORG	null
8 friends friends friends foreign unspecified unspecified unspecified unspecified unspecified  	I_ORG	null
9 will will will foreign unspecified unspecified unspecified unspecified unspecified  	I_ORG	null
10 die die die foreign unspecified unspecified unspecified unspecified unspecified  	I_ORG	null
11 So So So foreign unspecified unspecified unspecified unspecified unspecified  	I_ORG	null
12 lead lead lead foreign unspecified unspecified unspecified unspecified unspecified  	I_ORG	null
13 a a a foreign unspecified unspecified unspecified unspecified unspecified  	I_ORG	null
14 clean clean clean foreign unspecified unspecified unspecified unspecified unspecified  	I_ORG	null
15 and and and foreign unspecified unspecified unspecified unspecified unspecified  	I_ORG	null
16 wholesome wholesome wholesome foreign unspecified unspecified unspecified unspecified unspecified  	I_ORG	null
17 life life life foreign unspecified unspecified unspecified unspecified unspecified  	I_ORG	null
18 And And And foreign unspecified unspecified unspecified unspecified unspecified  	I_ORG	null
19 join join join foreign unspecified unspecified unspecified unspecified unspecified  	I_ORG	null
20 them them them foreign unspecified unspecified unspecified unspecified unspecified  	I_ORG	null
21 in in in foreign unspecified unspecified unspecified unspecified unspecified  	I_ORG	null
22 the the the foreign unspecified unspecified unspecified unspecified unspecified  	I_ORG	null
23 sky sky sky foreign unspecified unspecified unspecified unspecified unspecified  	I_ORG	null
24 . . . punctuation unspecified unspecified unspecified unspecified unspecified  	O	null

