0 Happiness Happiness Happiness foreign unspecified unspecified unspecified unspecified unspecified  	O	null
1 , , , punctuation unspecified unspecified unspecified unspecified unspecified  	O	null
2 when when when foreign unspecified unspecified unspecified unspecified unspecified  	I_ORG	null
3 you you you foreign unspecified unspecified unspecified unspecified unspecified  	I_ORG	null
4 come come come foreign unspecified unspecified unspecified unspecified unspecified  	I_ORG	null
5 to to to foreign unspecified unspecified unspecified unspecified unspecified  	I_ORG	null
6 India India India foreign unspecified unspecified unspecified unspecified unspecified  	I_ORG	null
7 is is is foreign unspecified unspecified unspecified unspecified unspecified  	I_ORG	null
8 my my my foreign unspecified unspecified unspecified unspecified unspecified  	I_ORG	null
9 problem problem problem foreign unspecified unspecified unspecified unspecified unspecified  	I_ORG	null

0 Ohm Ohm Ohm foreign unspecified unspecified unspecified unspecified unspecified  	I_ORG	null
1 Namo Namo Namo foreign unspecified unspecified unspecified unspecified unspecified  	I_ORG	null
2 Magwate Magwate Magwate foreign unspecified unspecified unspecified unspecified unspecified  	I_ORG	null
3 Washu Washu Washu foreign unspecified unspecified unspecified unspecified unspecified  	I_ORG	null
4 Deway Deway Deway foreign unspecified unspecified unspecified unspecified unspecified  	I_ORG	null
5 Namo Namo Namo foreign unspecified unspecified unspecified unspecified unspecified  	I_ORG	null
6 , , , punctuation unspecified unspecified unspecified unspecified unspecified  	O	null
7 Guru Guru Guru foreign unspecified unspecified unspecified unspecified unspecified  	O	null
8 , , , punctuation unspecified unspecified unspecified unspecified unspecified  	O	null
9 Rama Rama Rama foreign unspecified unspecified unspecified unspecified unspecified  	O	null
10 , , , punctuation unspecified unspecified unspecified unspecified unspecified  	O	null
11 Guru Guru Guru foreign unspecified unspecified unspecified unspecified unspecified  	O	null
12 , , , punctuation unspecified unspecified unspecified unspecified unspecified  	O	null
13 Vishnu Vishnu Vishnu foreign unspecified unspecified unspecified unspecified unspecified  	O	null
14 Guru Guru Guru foreign unspecified unspecified unspecified unspecified unspecified  	O	null
15 , , , punctuation unspecified unspecified unspecified unspecified unspecified  	O	null
16 Deo Deo Deo foreign unspecified unspecified unspecified unspecified unspecified  	O	null
17 , , , punctuation unspecified unspecified unspecified unspecified unspecified  	O	null
18 Mashware Mashware Mashware foreign unspecified unspecified unspecified unspecified unspecified  	O	null
19 , , , punctuation unspecified unspecified unspecified unspecified unspecified  	O	null
20 Guru Guru Guru foreign unspecified unspecified unspecified unspecified unspecified  	O	null
21 , , , punctuation unspecified unspecified unspecified unspecified unspecified  	O	null
22 Sacha Sacha Sacha foreign unspecified unspecified unspecified unspecified unspecified  	I_ORG	null

0 Tasmecheri Tasmecheri Tasmecheri foreign unspecified unspecified unspecified unspecified unspecified  	I_ORG	null
1 Bruenu Bruenu Bruenu foreign unspecified unspecified unspecified unspecified unspecified  	I_ORG	null
2 Pushkar Pushkar Pushkar foreign unspecified unspecified unspecified unspecified unspecified  	I_ORG	null
3 guru guru guru foreign unspecified unspecified unspecified unspecified unspecified  	I_ORG	null
4 I I I foreign unspecified unspecified unspecified unspecified unspecified  	I_ORG	null
5 give give give foreign unspecified unspecified unspecified unspecified unspecified  	I_ORG	null
6 you you you foreign unspecified unspecified unspecified unspecified unspecified  	I_ORG	null
7 Holy Holy Holy foreign unspecified unspecified unspecified unspecified unspecified  	I_ORG	null
8 flower flower flower foreign unspecified unspecified unspecified unspecified unspecified  	I_ORG	null
9 And And And foreign unspecified unspecified unspecified unspecified unspecified  	I_ORG	null
10 you you you foreign unspecified unspecified unspecified unspecified unspecified  	I_ORG	null
11 give give give foreign unspecified unspecified unspecified unspecified unspecified  	I_ORG	null
12 me me me foreign unspecified unspecified unspecified unspecified unspecified  	I_ORG	null
13 happy happy happy foreign unspecified unspecified unspecified unspecified unspecified  	I_ORG	null
14 traveling traveling traveling foreign unspecified unspecified unspecified unspecified unspecified  	I_ORG	null
15 in in in foreign unspecified unspecified unspecified unspecified unspecified  	I_ORG	null
16 India India India foreign unspecified unspecified unspecified unspecified unspecified  	I_ORG	null

0 What What What foreign unspecified unspecified unspecified unspecified unspecified  	O	null
1 is is is foreign unspecified unspecified unspecified unspecified unspecified  	O	null
2 karma karma karma foreign unspecified unspecified unspecified unspecified unspecified  	O	null
3 ? ? ? punctuation unspecified unspecified unspecified unspecified unspecified  	O	null

0 If If If foreign unspecified unspecified unspecified unspecified unspecified  	I_ORG	null
1 you you you foreign unspecified unspecified unspecified unspecified unspecified  	I_ORG	null
2 do do do foreign unspecified unspecified unspecified unspecified unspecified  	I_ORG	null
3 something something something foreign unspecified unspecified unspecified unspecified unspecified  	I_ORG	null
4 good good good foreign unspecified unspecified unspecified unspecified unspecified  	I_ORG	null
5 it it it foreign unspecified unspecified unspecified unspecified unspecified  	I_ORG	null
6 will will will foreign unspecified unspecified unspecified unspecified unspecified  	I_ORG	null
7 come come come foreign unspecified unspecified unspecified unspecified unspecified  	I_ORG	null
8 back back back foreign unspecified unspecified unspecified unspecified unspecified  	I_ORG	null
9 in in in foreign unspecified unspecified unspecified unspecified unspecified  	I_ORG	null
10 your your your foreign unspecified unspecified unspecified unspecified unspecified  	I_ORG	null
11 life life life foreign unspecified unspecified unspecified unspecified unspecified  	I_ORG	null

0 Hariharo Hariharo Hariharo foreign unspecified unspecified unspecified unspecified unspecified  	O	null
1 , , , punctuation unspecified unspecified unspecified unspecified unspecified  	O	null
2 rockdosh rockdosh rockdosh foreign unspecified unspecified unspecified unspecified unspecified  	O	null
3 , , , punctuation unspecified unspecified unspecified unspecified unspecified  	O	null
4 kashklesh kashklesh kashklesh foreign unspecified unspecified unspecified unspecified unspecified  	O	null
5 , , , punctuation unspecified unspecified unspecified unspecified unspecified  	O	null
6 hirakadi hirakadi hirakadi foreign unspecified unspecified unspecified unspecified unspecified  	O	null
7 chintahari chintahari chintahari foreign unspecified unspecified unspecified unspecified unspecified  	O	null
8 , , , punctuation unspecified unspecified unspecified unspecified unspecified  	O	null
9 hariharam hariharam hariharam foreign unspecified unspecified unspecified unspecified unspecified  	O	null
10 , , , punctuation unspecified unspecified unspecified unspecified unspecified  	O	null
11 pushkar pushkar pushkar foreign unspecified unspecified unspecified unspecified unspecified  	I_ORG	null
12 guru guru guru foreign unspecified unspecified unspecified unspecified unspecified  	I_ORG	null
13 I I I foreign unspecified unspecified unspecified unspecified unspecified  	I_ORG	null
14 give give give foreign unspecified unspecified unspecified unspecified unspecified  	I_ORG	null
15 you you you foreign unspecified unspecified unspecified unspecified unspecified  	I_ORG	null
16 Red Red Red foreign unspecified unspecified unspecified unspecified unspecified  	I_ORG	null
17 colour colour colour foreign unspecified unspecified unspecified unspecified unspecified  	I_ORG	null
18 And And And foreign unspecified unspecified unspecified unspecified unspecified  	I_ORG	null
19 holy holy holy foreign unspecified unspecified unspecified unspecified unspecified  	I_ORG	null
20 rice rice rice foreign unspecified unspecified unspecified unspecified unspecified  	I_ORG	null

0 תכל תכל תכל properName unspecified unspecified unspecified unspecified unspecified  	I_PERS	null
1 ‘ ‘ ‘ punctuation unspecified unspecified unspecified unspecified unspecified  	O	null
2 ס ס ס properName unspecified unspecified unspecified unspecified unspecified  	I_PERS	null
3 , , , punctuation unspecified unspecified unspecified unspecified unspecified  	O	null
4 אני הוא אני pronoun masculine-and-feminine singular unspecified 1 unspecified  	O	null
5 יכול יכול יכול modal masculine singular unspecified any beinoni  	O	null
6 עוד עוד עוד adverb unspecified unspecified unspecified unspecified unspecified  	O	null
7 הרבה הרבה הרבה adverb unspecified unspecified unspecified unspecified unspecified  	O	null
8 זמן... זמן... זמן... properName unspecified unspecified unspecified unspecified unspecified  	I_PERS	null
9 היה הוא היה copula masculine singular unspecified 3 past  	O	null
10 ל ל לכם preposition unspecified unspecified unspecified unspecified unspecified  
10 כם כם לכם pronomial masculine plural unspecified 2 unspecified 0 	O	null
11 פעם פעם פעם adverb unspecified unspecified unspecified unspecified unspecified  	O	null
12 סיוטים סיוט סיוטים noun masculine plural absolute unspecified unspecified  	O	null
13 כ כ כאלה preposition unspecified unspecified unspecified unspecified unspecified 0 
13 אלה אלה כאלה pronoun masculine-and-feminine plural unspecified 3 unspecified  	O	null
14 ש ש שאנחנו relativizer/subordinatingConjunction unspecified unspecified unspecified unspecified unspecified 0 
14 אנחנו הוא שאנחנו pronoun masculine-and-feminine plural unspecified 1 unspecified  	O	null
15 כאילו כאילו כאילו conjunction unspecified unspecified unspecified unspecified unspecified  	O	null
16 נגיד הגיד נגיד verb masculine-and-feminine plural unspecified 1 future  	O	null
17 ב ב בהופעה preposition unspecified unspecified unspecified unspecified unspecified 0 
17 הופעה הופעה בהופעה noun feminine singular absolute unspecified unspecified  	O	null
18 ו ו ויש conjunction unspecified unspecified unspecified unspecified unspecified 0 
18 יש יש ויש existential unspecified unspecified unspecified unspecified unspecified  	O	null
19 מ מ מלא preposition unspecified unspecified unspecified unspecified unspecified 0 
19 לא לא מלא negation unspecified unspecified unspecified unspecified unspecified  	O	null
20 בעיות בעיה בעיות noun feminine plural absolute unspecified unspecified  	O	null
21 טכניות טכני טכניות adjective feminine plural absolute unspecified unspecified  	O	null
22 ו ו וכאילו conjunction unspecified unspecified unspecified unspecified unspecified 0 
22 כאילו כאילו וכאילו conjunction unspecified unspecified unspecified unspecified unspecified  	O	null
23 לא לא לא negation unspecified unspecified unspecified unspecified unspecified  	O	null
24 מצליחים הצליח מצליחים verb masculine plural unspecified any beinoni  	O	null
25 לנגן ניגן לנגן verb unspecified unspecified unspecified unspecified infinitive  	O	null
26 ? ? ? punctuation unspecified unspecified unspecified unspecified unspecified  	O	null

0 What What What foreign unspecified unspecified unspecified unspecified unspecified  	O	null
1 is is is foreign unspecified unspecified unspecified unspecified unspecified  	O	null
2 karma karma karma foreign unspecified unspecified unspecified unspecified unspecified  	O	null
3 ? ? ? punctuation unspecified unspecified unspecified unspecified unspecified  	O	null

0 If If If foreign unspecified unspecified unspecified unspecified unspecified  	I_ORG	null
1 you you you foreign unspecified unspecified unspecified unspecified unspecified  	I_ORG	null
2 do do do foreign unspecified unspecified unspecified unspecified unspecified  	I_ORG	null
3 something something something foreign unspecified unspecified unspecified unspecified unspecified  	I_ORG	null
4 good good good foreign unspecified unspecified unspecified unspecified unspecified  	I_ORG	null
5 it it it foreign unspecified unspecified unspecified unspecified unspecified  	I_ORG	null
6 will will will foreign unspecified unspecified unspecified unspecified unspecified  	I_ORG	null
7 come come come foreign unspecified unspecified unspecified unspecified unspecified  	I_ORG	null
8 back back back foreign unspecified unspecified unspecified unspecified unspecified  	I_ORG	null
9 in in in foreign unspecified unspecified unspecified unspecified unspecified  	I_ORG	null
10 your your your foreign unspecified unspecified unspecified unspecified unspecified  	I_ORG	null
11 life life life foreign unspecified unspecified unspecified unspecified unspecified  	I_ORG	null
12 One One One foreign unspecified unspecified unspecified unspecified unspecified  	I_ORG	null
13 time time time foreign unspecified unspecified unspecified unspecified unspecified  	I_ORG	null
14 One One One foreign unspecified unspecified unspecified unspecified unspecified  	I_ORG	null
15 life life life foreign unspecified unspecified unspecified unspecified unspecified  	I_ORG	null
16 Good Good Good foreign unspecified unspecified unspecified unspecified unspecified  	I_ORG	null
17 luck luck luck foreign unspecified unspecified unspecified unspecified unspecified  	I_ORG	null

0 Good Good Good foreign unspecified unspecified unspecified unspecified unspecified  	I_ORG	null
1 karma karma karma foreign unspecified unspecified unspecified unspecified unspecified  	I_ORG	null
2 In In In foreign unspecified unspecified unspecified unspecified unspecified  	I_ORG	null
3 your your your foreign unspecified unspecified unspecified unspecified unspecified  	I_ORG	null
4 life life life foreign unspecified unspecified unspecified unspecified unspecified  	I_ORG	null

0 יאיר יאיר יאיר properName unspecified unspecified unspecified unspecified unspecified  	I_PERS	null
1 , , , punctuation unspecified unspecified unspecified unspecified unspecified  	O	null
2 מה מה מהי interrogative unspecified unspecified unspecified unspecified unspecified  
2 ה ה מהי pronomial feminine singular unspecified 3 unspecified 0 	O	null
3 קרמה קרם קרמה verb feminine singular unspecified 3 past  	O	null
4 ? ? ? punctuation unspecified unspecified unspecified unspecified unspecified  	O	null

0 למה למה למה interrogative unspecified unspecified unspecified unspecified unspecified  	O	null
1 אתה הוא אתה pronoun masculine singular unspecified 2 unspecified  	O	null
2 לא לא לא negation unspecified unspecified unspecified unspecified unspecified  	O	null
3 עונה ענה עונה verb masculine singular unspecified any beinoni  	O	null
4 ל ל לי preposition unspecified unspecified unspecified unspecified unspecified  
4 י י לי pronomial masculine-and-feminine singular unspecified 1 unspecified 0 	O	null
5 ? ? ? punctuation unspecified unspecified unspecified unspecified unspecified  	O	null

0 תענה ענה תענה verb feminine singular unspecified 3 future  	O	null
1 ל ל לו preposition unspecified unspecified unspecified unspecified unspecified  
1 ו ו לו pronomial masculine singular unspecified 3 unspecified 0 	O	null
2 ו ו והוא conjunction unspecified unspecified unspecified unspecified unspecified 0 
2 הוא הוא והוא pronoun masculine singular unspecified 3 unspecified  	O	null
3 יפסיק הפסיק יפסיק verb masculine singular unspecified 3 future  	O	null
4 בוא בא בוא verb masculine singular unspecified 2 imperative  	O	null
5 אלי אל אלי preposition unspecified unspecified unspecified unspecified unspecified  	O	null
6 זה זה זה pronoun masculine singular unspecified 3 unspecified  	O	null
7 קטע קטע קטע noun masculine singular absolute unspecified unspecified  	O	null
8 רוחני רוחני רוחני adjective masculine singular absolute unspecified unspecified  	O	null
9 מה מה מהי interrogative unspecified unspecified unspecified unspecified unspecified  
9 ה ה מהי pronomial feminine singular unspecified 3 unspecified 0 	O	null
10 קרמה קרם קרמה verb feminine singular unspecified 3 past  	O	null
11 ? ? ? punctuation unspecified unspecified unspecified unspecified unspecified  	O	null

0 היה הוא היה copula masculine singular unspecified 3 past  	O	null
1 ל ל לכם preposition unspecified unspecified unspecified unspecified unspecified  
1 כם כם לכם pronomial masculine plural unspecified 2 unspecified 0 	O	null
2 פעם פעם פעם adverb unspecified unspecified unspecified unspecified unspecified  	O	null
3 סיוטים סיוט סיוטים noun masculine plural absolute unspecified unspecified  	O	null
4 כ כ כאלה preposition unspecified unspecified unspecified unspecified unspecified 0 
4 אלה אלה כאלה pronoun masculine-and-feminine plural unspecified 3 unspecified  	O	null
5 ש ש שאנחנו relativizer/subordinatingConjunction unspecified unspecified unspecified unspecified unspecified 0 
5 אנחנו הוא שאנחנו pronoun masculine-and-feminine plural unspecified 1 unspecified  	O	null
6 כאילו כאילו כאילו conjunction unspecified unspecified unspecified unspecified unspecified  	O	null
7 נגיד הגיד נגיד verb masculine-and-feminine plural unspecified 1 future  	O	null
8 ב ב בהופעה preposition unspecified unspecified unspecified unspecified unspecified 0 
8 הופעה הופעה בהופעה noun feminine singular absolute unspecified unspecified  	O	null
9 ו ו ויש conjunction unspecified unspecified unspecified unspecified unspecified 0 
9 יש יש ויש existential unspecified unspecified unspecified unspecified unspecified  	O	null
10 מ מ מלא preposition unspecified unspecified unspecified unspecified unspecified 0 
10 לא לא מלא negation unspecified unspecified unspecified unspecified unspecified  	O	null
11 בעיות בעיה בעיות noun feminine plural absolute unspecified unspecified  	O	null
12 טכניות טכני טכניות adjective feminine plural absolute unspecified unspecified  	O	null
13 ו ו וכאילו conjunction unspecified unspecified unspecified unspecified unspecified 0 
13 כאילו כאילו וכאילו conjunction unspecified unspecified unspecified unspecified unspecified  	O	null
14 לא לא לא negation unspecified unspecified unspecified unspecified unspecified  	O	null
15 מצליחים הצליח מצליחים verb masculine plural unspecified any beinoni  	O	null
16 לנגן ניגן לנגן verb unspecified unspecified unspecified unspecified infinitive  	O	null
17 ? ? ? punctuation unspecified unspecified unspecified unspecified unspecified  	O	null

