0 אצלנו אצל אצלנו verb masculine-and-feminine plural unspecified 1 past  	I_LOC	null
1 ב ב בכפר preposition unspecified unspecified unspecified unspecified unspecified 0 
1 כפר כפר בכפר noun masculine singular construct unspecified unspecified  	I_LOC	null
2 טודרא טודרא טודרא properName unspecified unspecified unspecified unspecified unspecified  	I_LOC	null
3 ש ש שבלב relativizer/subordinatingConjunction unspecified unspecified unspecified unspecified unspecified 0 
3 ב ב שבלב preposition unspecified unspecified unspecified unspecified unspecified 0 
3 לב לב שבלב noun masculine singular construct unspecified unspecified  	O	null
4 הרי הר הרי noun masculine plural construct unspecified unspecified  	O	null
5 ה ה האטלס definiteArticle unspecified unspecified unspecified unspecified unspecified 0 
5 האטלס אטלס האטלס noun masculine singular absolute unspecified unspecified  	O	null
6 היו הוא היו copula masculine plural unspecified 2 imperative  	O	null
7 לוקחים לקח לוקחים verb masculine plural unspecified any beinoni  	O	null
8 את את את at-preposition unspecified unspecified unspecified unspecified unspecified  	O	null
9 ה ה הילד definiteArticle unspecified unspecified unspecified unspecified unspecified 0 
9 הילד ילד הילד noun masculine singular absolute unspecified unspecified  	O	null
10 ש ש שהגיע relativizer/subordinatingConjunction unspecified unspecified unspecified unspecified unspecified 0 
10 הגיע הגיע שהגיע verb masculine singular unspecified 3 past  	O	null
11 ל ל לגיל preposition unspecified unspecified unspecified unspecified unspecified 0 
11 גיל גיל לגיל noun masculine singular construct unspecified unspecified  	O	null
12 חמש CARD5 חמש numeral feminine singular absolute unspecified unspecified  	O	null
13 כתר כתר כתר noun masculine singular construct unspecified unspecified  	O	null
14 פרחים פרח פרחים noun masculine plural absolute unspecified unspecified  	O	null
15 עושים עשה עושים verb masculine plural unspecified any beinoni  	O	null
16 לו לו לו conjunction unspecified unspecified unspecified unspecified unspecified  	O	null
17 אצלנו אצל אצלנו verb masculine-and-feminine plural unspecified 1 past  	I_LOC	null
18 ב ב בכפר preposition unspecified unspecified unspecified unspecified unspecified 0 
18 כפר כפר בכפר noun masculine singular construct unspecified unspecified  	I_LOC	null
19 טודרא טודרא טודרא properName unspecified unspecified unspecified unspecified unspecified  	I_LOC	null
20 כתר כתר כתר noun masculine singular absolute unspecified unspecified  	O	null
21 ב ב בראש preposition unspecified unspecified unspecified unspecified unspecified 0 
21 ראש ראש בראש noun masculine singular absolute unspecified unspecified  	O	null
22 מלבישים הלביש מלבישים verb masculine plural unspecified any beinoni  	O	null
23 לו לו לו conjunction unspecified unspecified unspecified unspecified unspecified  	O	null
24 ש ש שהגיע relativizer/subordinatingConjunction unspecified unspecified unspecified unspecified unspecified 0 
24 הגיע הגיע שהגיע verb masculine singular unspecified 3 past  	O	null
25 ל ל לגיל preposition unspecified unspecified unspecified unspecified unspecified 0 
25 גיל גיל לגיל noun masculine singular construct unspecified unspecified  	O	null
26 חמש CARD5 חמש numeral feminine singular absolute unspecified unspecified  	O	null
27 כל כול כל quantifier unspecified unspecified construct unspecified unspecified  	O	null
28 ה ה הילדים definiteArticle unspecified unspecified unspecified unspecified unspecified 0 
28 הילדים ילד הילדים noun masculine plural absolute unspecified unspecified  	O	null
29 ב ב ברחוב preposition unspecified unspecified unspecified unspecified unspecified 0 
29 רחוב רחוב ברחוב noun masculine singular construct unspecified unspecified  	O	null
30 חגיגה חגיגה חגיגה noun feminine singular absolute unspecified unspecified  	O	null
31 גדולה גדול גדולה adjective feminine singular absolute unspecified unspecified  	O	null
32 עורכים ערך עורכים verb masculine plural unspecified any beinoni  	O	null
33 לו לו לו conjunction unspecified unspecified unspecified unspecified unspecified  	O	null
34 ש ש שהגיע relativizer/subordinatingConjunction unspecified unspecified unspecified unspecified unspecified 0 
34 הגיע הגיע שהגיע verb masculine singular unspecified 3 past  	O	null
35 ל ל לגיל preposition unspecified unspecified unspecified unspecified unspecified 0 
35 גיל גיל לגיל noun masculine singular construct unspecified unspecified  	O	null
36 חמש CARD5 חמש numeral feminine singular absolute unspecified unspecified  	O	null
37 אצלנו אצל אצלנו verb masculine-and-feminine plural unspecified 1 past  	I_LOC	null
38 ב ב בכפר preposition unspecified unspecified unspecified unspecified unspecified 0 
38 כפר כפר בכפר noun masculine singular absolute unspecified unspecified  	I_LOC	null
39 טודרא טודרא טודרא properName unspecified unspecified unspecified unspecified unspecified  	I_LOC	null

0 לה לה לה properName unspecified unspecified unspecified unspecified unspecified  	I_PERS	null
1 , , , punctuation unspecified unspecified unspecified unspecified unspecified  	O	null
2 לה לה לה properName unspecified unspecified unspecified unspecified unspecified  	I_PERS	null
3 , , , punctuation unspecified unspecified unspecified unspecified unspecified  	O	null
4 לה... לה... לה... verb masculine singular unspecified 2 imperative  	O	null

0 ו ו ואז conjunction unspecified unspecified unspecified unspecified unspecified 0 
0 אז אז ואז conjunction unspecified unspecified unspecified unspecified unspecified  	O	null
1 את את את at-preposition unspecified unspecified unspecified unspecified unspecified  	O	null
2 חתן חתן חתן noun masculine singular construct unspecified unspecified  	O	null
3 ה ה השמחה definiteArticle unspecified unspecified unspecified unspecified unspecified 0 
3 השמחה שמחה השמחה noun feminine singular absolute unspecified unspecified  	O	null
4 ש ש שהגיע relativizer/subordinatingConjunction unspecified unspecified unspecified unspecified unspecified 0 
4 הגיע הגיע שהגיע verb masculine singular unspecified 3 past  	O	null
5 ל ל לגיל preposition unspecified unspecified unspecified unspecified unspecified 0 
5 גיל גיל לגיל noun masculine singular construct unspecified unspecified  	O	null
6 חמש CARD5 חמש numeral feminine singular absolute unspecified unspecified  	O	null
7 אצלנו אצל אצלנו verb masculine-and-feminine plural unspecified 1 past  	I_LOC	null
8 ב ב בכפר preposition unspecified unspecified unspecified unspecified unspecified 0 
8 כפר כפר בכפר noun masculine singular construct unspecified unspecified  	I_LOC	null
9 טודרא טודרא טודרא properName unspecified unspecified unspecified unspecified unspecified  	I_LOC	null
10 מכניסים הכניס מכניסים verb masculine plural unspecified any beinoni  	O	null
11 ל ל לבית preposition unspecified unspecified unspecified unspecified unspecified 0 
11 בית בית לבית noun masculine singular construct unspecified unspecified  	O	null
12 ה ה הכנסת definiteArticle unspecified unspecified unspecified unspecified unspecified 0 
12 הכנסת כנסת הכנסת properName feminine singular unspecified unspecified unspecified  	I_ORG	null
13 ו ו וכותבים conjunction unspecified unspecified unspecified unspecified unspecified 0 
13 כותבים כתב וכותבים verb masculine plural unspecified any beinoni  	O	null
14 על על על preposition unspecified unspecified unspecified unspecified unspecified  	O	null
15 לוח לוח לוח noun masculine singular construct unspecified unspecified  	O	null
16 של של של shel-preposition unspecified unspecified unspecified unspecified unspecified  	O	null
17 עץ עץ עץ noun masculine singular absolute unspecified unspecified  	O	null
18 ב ב בדבש preposition unspecified unspecified unspecified unspecified unspecified 0 
18 דבש דבש בדבש noun masculine singular absolute unspecified unspecified  	O	null
19 מא מא מא properName unspecified unspecified unspecified unspecified unspecified  	I_LOC	null
20 ' ' ' punctuation unspecified unspecified unspecified unspecified unspecified  	O	null
21 ו ו ועד conjunction unspecified unspecified unspecified unspecified unspecified 0 
21 עד עד ועד preposition unspecified unspecified unspecified unspecified unspecified  	O	null
22 ת' ת' ת' noun masculine singular absolute unspecified unspecified  	O	null
23 את את את at-preposition unspecified unspecified unspecified unspecified unspecified  	O	null
24 כל כול כל quantifier unspecified unspecified construct unspecified unspecified  	O	null
25 ה ה האותיות definiteArticle unspecified unspecified unspecified unspecified unspecified 0 
25 האותיות אות האותיות noun feminine plural absolute unspecified unspecified  	O	null
26 ב ב בדבש preposition unspecified unspecified unspecified unspecified unspecified 0 
26 ה ה בדבש definiteArticle unspecified unspecified unspecified unspecified unspecified 0 
26 הדבש דבש בדבש noun masculine singular absolute unspecified unspecified  	O	null
27 ו ו ואומרים conjunction unspecified unspecified unspecified unspecified unspecified 0 
27 אומרים אמר ואומרים verb masculine plural unspecified any beinoni  	O	null
28 ל ל לו preposition unspecified unspecified unspecified unspecified unspecified  
28 ו ו לו pronomial masculine singular unspecified 3 unspecified 0 	O	null
29 : : : punctuation unspecified unspecified unspecified unspecified unspecified  	O	null
30 חביבי חביב חביבי adjective masculine plural construct unspecified unspecified  	O	null
31 , , , punctuation unspecified unspecified unspecified unspecified unspecified  	O	null
32 לקק ליקק לקק verb masculine singular unspecified 3 past  	O	null
33 ! ! ! punctuation unspecified unspecified unspecified unspecified unspecified  	O	null

0 ו ו והיתה conjunction unspecified unspecified unspecified unspecified unspecified 0 
0 היתה הוא והיתה copula feminine singular unspecified 3 past  	O	null
1 ה ה התורה definiteArticle unspecified unspecified unspecified unspecified unspecified 0 
1 התורה תורה התורה noun feminine singular absolute unspecified unspecified  	O	null
2 ש ש שבפה relativizer/subordinatingConjunction unspecified unspecified unspecified unspecified unspecified 0 
2 ב ב שבפה preposition unspecified unspecified unspecified unspecified unspecified 0 
2 פה פה שבפה noun masculine singular absolute unspecified unspecified  	O	null
3 מתוקה מתוק מתוקה adjective feminine singular absolute unspecified unspecified  	O	null
4 כמו כמו כמו preposition unspecified unspecified unspecified unspecified unspecified  	O	null
5 טעם טעם טעם noun masculine singular absolute unspecified unspecified  	O	null
6 של של של shel-preposition unspecified unspecified unspecified unspecified unspecified  	O	null
7 דבש דבש דבש properName unspecified unspecified unspecified unspecified unspecified  	I_PERS	null
8 אצלנו אצל אצלנו verb masculine-and-feminine plural unspecified 1 past  	I_LOC	null
9 ב ב בכפר preposition unspecified unspecified unspecified unspecified unspecified 0 
9 כפר כפר בכפר noun masculine singular construct unspecified unspecified  	I_LOC	null
10 טודרא טודרא טודרא properName unspecified unspecified unspecified unspecified unspecified  	I_LOC	null
11 ש ש שבלב relativizer/subordinatingConjunction unspecified unspecified unspecified unspecified unspecified 0 
11 ב ב שבלב preposition unspecified unspecified unspecified unspecified unspecified 0 
11 לב לב שבלב noun masculine singular construct unspecified unspecified  	O	null
12 הרי הר הרי noun masculine plural construct unspecified unspecified  	O	null
13 ה ה האטלס definiteArticle unspecified unspecified unspecified unspecified unspecified 0 
13 האטלס אטלס האטלס noun masculine singular absolute unspecified unspecified  	O	null

0 לה לה לה properName unspecified unspecified unspecified unspecified unspecified  	I_PERS	null
1 , , , punctuation unspecified unspecified unspecified unspecified unspecified  	O	null
2 לה לה לה properName unspecified unspecified unspecified unspecified unspecified  	I_PERS	null
3 , , , punctuation unspecified unspecified unspecified unspecified unspecified  	O	null
4 לה... לה... לה... verb masculine singular unspecified 2 imperative  	O	null

