0 were were were foreign unspecified unspecified unspecified unspecified unspecified  	O	null
1 gonna gonna gonna foreign unspecified unspecified unspecified unspecified unspecified  	O	null
2 main main main foreign unspecified unspecified unspecified unspecified unspecified  	O	null
3 ... ... ... punctuation unspecified unspecified unspecified unspecified unspecified  	O	null

0 have have have foreign unspecified unspecified unspecified unspecified unspecified  	I_ORG	null
1 is is is foreign unspecified unspecified unspecified unspecified unspecified  	I_ORG	null
2 this this this foreign unspecified unspecified unspecified unspecified unspecified  	I_ORG	null
3 power power power foreign unspecified unspecified unspecified unspecified unspecified  	I_ORG	null
4 ........ ........ ........ punctuation unspecified unspecified unspecified unspecified unspecified  	O	null

0 where where where foreign unspecified unspecified unspecified unspecified unspecified  	I_ORG	null
1 relieved relieved relieved foreign unspecified unspecified unspecified unspecified unspecified  	I_ORG	null
2 where where where foreign unspecified unspecified unspecified unspecified unspecified  	I_ORG	null
3 is is is foreign unspecified unspecified unspecified unspecified unspecified  	I_ORG	null
4 of of of foreign unspecified unspecified unspecified unspecified unspecified  	I_ORG	null
5 high-er high-er high-er foreign unspecified unspecified unspecified unspecified unspecified  	I_ORG	null

0 know know know foreign unspecified unspecified unspecified unspecified unspecified  	I_ORG	null
1 mama mama mama foreign unspecified unspecified unspecified unspecified unspecified  	I_ORG	null
2 said said said foreign unspecified unspecified unspecified unspecified unspecified  	I_ORG	null
3 its its its foreign unspecified unspecified unspecified unspecified unspecified  	I_ORG	null
4 where where where foreign unspecified unspecified unspecified unspecified unspecified  	I_ORG	null
5 they they they foreign unspecified unspecified unspecified unspecified unspecified  	I_ORG	null
6 go go go foreign unspecified unspecified unspecified unspecified unspecified  	I_ORG	null
7 on on on foreign unspecified unspecified unspecified unspecified unspecified  	I_ORG	null
8 the the the foreign unspecified unspecified unspecified unspecified unspecified  	I_ORG	null
9 land land land foreign unspecified unspecified unspecified unspecified unspecified  	I_ORG	null
10 when when when foreign unspecified unspecified unspecified unspecified unspecified  	I_ORG	null
11 you you you foreign unspecified unspecified unspecified unspecified unspecified  	I_ORG	null
12 myself myself myself foreign unspecified unspecified unspecified unspecified unspecified  	I_ORG	null
13 your your your foreign unspecified unspecified unspecified unspecified unspecified  	I_ORG	null
14 steeling steeling steeling foreign unspecified unspecified unspecified unspecified unspecified  	I_ORG	null
15 yourself-ah yourself-ah yourself-ah foreign unspecified unspecified unspecified unspecified unspecified  	I_ORG	null

0 so so so foreign unspecified unspecified unspecified unspecified unspecified  	I_ORG	null
1 my my my foreign unspecified unspecified unspecified unspecified unspecified  	I_ORG	null
2 is is is foreign unspecified unspecified unspecified unspecified unspecified  	I_ORG	null
3 a a a foreign unspecified unspecified unspecified unspecified unspecified  	I_ORG	null
4 no no no foreign unspecified unspecified unspecified unspecified unspecified  	I_ORG	null
5 idea idea idea foreign unspecified unspecified unspecified unspecified unspecified  	I_ORG	null
6 where where where foreign unspecified unspecified unspecified unspecified unspecified  	I_ORG	null
7 i i i foreign unspecified unspecified unspecified unspecified unspecified  	I_ORG	null
8 go go go foreign unspecified unspecified unspecified unspecified unspecified  	I_ORG	null
9 me me me foreign unspecified unspecified unspecified unspecified unspecified  	I_ORG	null
10 i i i foreign unspecified unspecified unspecified unspecified unspecified  	I_ORG	null
11 am am am foreign unspecified unspecified unspecified unspecified unspecified  	I_ORG	null
12 a a a foreign unspecified unspecified unspecified unspecified unspecified  	I_ORG	null
13 flying flying flying foreign unspecified unspecified unspecified unspecified unspecified  	I_ORG	null
14 in in in foreign unspecified unspecified unspecified unspecified unspecified  	I_ORG	null
15 my my my foreign unspecified unspecified unspecified unspecified unspecified  	I_ORG	null
16 ways ways ways foreign unspecified unspecified unspecified unspecified unspecified  	I_ORG	null

0 no no no foreign unspecified unspecified unspecified unspecified unspecified  	I_ORG	null
1 better better better foreign unspecified unspecified unspecified unspecified unspecified  	I_ORG	null
2 no no no foreign unspecified unspecified unspecified unspecified unspecified  	I_ORG	null
3 go go go foreign unspecified unspecified unspecified unspecified unspecified  	I_ORG	null
4 i i i foreign unspecified unspecified unspecified unspecified unspecified  	I_ORG	null
5 will will will foreign unspecified unspecified unspecified unspecified unspecified  	I_ORG	null
6 find find find foreign unspecified unspecified unspecified unspecified unspecified  	I_ORG	null
7 the the the foreign unspecified unspecified unspecified unspecified unspecified  	I_ORG	null
8 ways ways ways foreign unspecified unspecified unspecified unspecified unspecified  	I_ORG	null

0 no no no foreign unspecified unspecified unspecified unspecified unspecified  	I_ORG	null
1 matter matter matter foreign unspecified unspecified unspecified unspecified unspecified  	I_ORG	null
2 of of of foreign unspecified unspecified unspecified unspecified unspecified  	I_ORG	null
3 illusion illusion illusion foreign unspecified unspecified unspecified unspecified unspecified  	I_ORG	null
4 in in in foreign unspecified unspecified unspecified unspecified unspecified  	I_ORG	null
5 i i i foreign unspecified unspecified unspecified unspecified unspecified  	I_ORG	null
6 am am am foreign unspecified unspecified unspecified unspecified unspecified  	I_ORG	null
7 a a a foreign unspecified unspecified unspecified unspecified unspecified  	I_ORG	null
8 feeling feeling feeling foreign unspecified unspecified unspecified unspecified unspecified  	I_ORG	null
9 a a a foreign unspecified unspecified unspecified unspecified unspecified  	I_ORG	null
10 bird bird bird foreign unspecified unspecified unspecified unspecified unspecified  	I_ORG	null
11 and and and foreign unspecified unspecified unspecified unspecified unspecified  	I_ORG	null
12 sky sky sky foreign unspecified unspecified unspecified unspecified unspecified  	I_ORG	null
13 and and and foreign unspecified unspecified unspecified unspecified unspecified  	I_ORG	null
14 since since since foreign unspecified unspecified unspecified unspecified unspecified  	I_ORG	null
15 the the the foreign unspecified unspecified unspecified unspecified unspecified  	I_ORG	null
16 air air air foreign unspecified unspecified unspecified unspecified unspecified  	I_ORG	null

0 oh oh oh foreign unspecified unspecified unspecified unspecified unspecified  	O	null
1 baby baby baby foreign unspecified unspecified unspecified unspecified unspecified  	O	null
2 * * * punctuation unspecified unspecified unspecified unspecified unspecified  	O	null
3 ) ) ) punctuation unspecified unspecified unspecified unspecified unspecified  	O	null
4 ' ' ' punctuation unspecified unspecified unspecified unspecified unspecified  	O	null
5 & & & punctuation unspecified unspecified unspecified unspecified unspecified  	O	null
6 $ $ $ noun masculine-and-feminine singular absolute unspecified unspecified  	O	null
7 # # # punctuation unspecified unspecified unspecified unspecified unspecified  	O	null
8 # # # punctuation unspecified unspecified unspecified unspecified unspecified  	O	null
9 * * * punctuation unspecified unspecified unspecified unspecified unspecified  	O	null
10 * * * punctuation unspecified unspecified unspecified unspecified unspecified  	O	null
11 you you you foreign unspecified unspecified unspecified unspecified unspecified  	I_ORG	null
12 making making making foreign unspecified unspecified unspecified unspecified unspecified  	I_ORG	null
13 feel feel feel foreign unspecified unspecified unspecified unspecified unspecified  	I_ORG	null
14 the the the foreign unspecified unspecified unspecified unspecified unspecified  	I_ORG	null
15 air air air foreign unspecified unspecified unspecified unspecified unspecified  	I_ORG	null
16 ... ... ... punctuation unspecified unspecified unspecified unspecified unspecified  	O	null

0 kiling-mala-sola kiling-mala-sola kiling-mala-sola foreign unspecified unspecified unspecified unspecified unspecified  	I_ORG	null
1 it it it foreign unspecified unspecified unspecified unspecified unspecified  	I_ORG	null
2 is is is foreign unspecified unspecified unspecified unspecified unspecified  	I_ORG	null
3 coming coming coming foreign unspecified unspecified unspecified unspecified unspecified  	I_ORG	null
4 from from from foreign unspecified unspecified unspecified unspecified unspecified  	I_ORG	null
5 far far far foreign unspecified unspecified unspecified unspecified unspecified  	I_ORG	null
6 the the the foreign unspecified unspecified unspecified unspecified unspecified  	I_ORG	null
7 mind mind mind foreign unspecified unspecified unspecified unspecified unspecified  	I_ORG	null
8 us us us foreign unspecified unspecified unspecified unspecified unspecified  	I_ORG	null
9 wave wave wave foreign unspecified unspecified unspecified unspecified unspecified  	I_ORG	null
10 in in in foreign unspecified unspecified unspecified unspecified unspecified  	I_ORG	null
11 the the the foreign unspecified unspecified unspecified unspecified unspecified  	I_ORG	null
12 air air air foreign unspecified unspecified unspecified unspecified unspecified  	I_ORG	null

0 cause cause cause foreign unspecified unspecified unspecified unspecified unspecified  	I_ORG	null
1 i i i foreign unspecified unspecified unspecified unspecified unspecified  	I_ORG	null
2 dont dont dont foreign unspecified unspecified unspecified unspecified unspecified  	I_ORG	null
3 mansafe mansafe mansafe foreign unspecified unspecified unspecified unspecified unspecified  	I_ORG	null
4 and and and foreign unspecified unspecified unspecified unspecified unspecified  	I_ORG	null
5 see see see foreign unspecified unspecified unspecified unspecified unspecified  	I_ORG	null
6 i'm i'm i'm foreign unspecified unspecified unspecified unspecified unspecified  	I_ORG	null
7 a a a foreign unspecified unspecified unspecified unspecified unspecified  	I_ORG	null
8 steeling steeling steeling foreign unspecified unspecified unspecified unspecified unspecified  	I_ORG	null
9 guy guy guy foreign unspecified unspecified unspecified unspecified unspecified  	I_ORG	null
10 its its its foreign unspecified unspecified unspecified unspecified unspecified  	I_ORG	null
11 sometimes sometimes sometimes foreign unspecified unspecified unspecified unspecified unspecified  	I_ORG	null
12 i i i foreign unspecified unspecified unspecified unspecified unspecified  	I_ORG	null

0 know know know foreign unspecified unspecified unspecified unspecified unspecified  	O	null
1 , , , punctuation unspecified unspecified unspecified unspecified unspecified  	O	null
2 , , , punctuation unspecified unspecified unspecified unspecified unspecified  	O	null
3 , , , punctuation unspecified unspecified unspecified unspecified unspecified  	O	null
4 , , , punctuation unspecified unspecified unspecified unspecified unspecified  	O	null
5 , , , punctuation unspecified unspecified unspecified unspecified unspecified  	O	null
6 sometimes sometimes sometimes foreign unspecified unspecified unspecified unspecified unspecified  	O	null
7 , , , punctuation unspecified unspecified unspecified unspecified unspecified  	O	null
8 , , , punctuation unspecified unspecified unspecified unspecified unspecified  	O	null
9 , , , punctuation unspecified unspecified unspecified unspecified unspecified  	O	null
10 , , , punctuation unspecified unspecified unspecified unspecified unspecified  	O	null
11 i i i foreign unspecified unspecified unspecified unspecified unspecified  	O	null
12 wonder wonder wonder foreign unspecified unspecified unspecified unspecified unspecified  	O	null
13 ....... ....... ....... punctuation unspecified unspecified unspecified unspecified unspecified  	O	null

0 * * * punctuation unspecified unspecified unspecified unspecified unspecified  	O	null
1 * * * punctuation unspecified unspecified unspecified unspecified unspecified  	O	null
2 * * * punctuation unspecified unspecified unspecified unspecified unspecified  	O	null
3 * * * punctuation unspecified unspecified unspecified unspecified unspecified  	O	null
4 ( ( ( punctuation unspecified unspecified unspecified unspecified unspecified  	O	null
5 ) ) ) punctuation unspecified unspecified unspecified unspecified unspecified  	O	null
6 ( ( ( punctuation unspecified unspecified unspecified unspecified unspecified  	O	null
7 ) ) ) punctuation unspecified unspecified unspecified unspecified unspecified  	O	null
8 & & & punctuation unspecified unspecified unspecified unspecified unspecified  	O	null
9 $ $ $ noun masculine-and-feminine singular absolute unspecified unspecified  	O	null
10 ) ) ) punctuation unspecified unspecified unspecified unspecified unspecified  	O	null
11 $ $ $ noun masculine-and-feminine singular absolute unspecified unspecified  	O	null
12 ' ' ' punctuation unspecified unspecified unspecified unspecified unspecified  	O	null
13 & & & punctuation unspecified unspecified unspecified unspecified unspecified  	O	null
14 * * * punctuation unspecified unspecified unspecified unspecified unspecified  	O	null
15 * * * punctuation unspecified unspecified unspecified unspecified unspecified  	O	null
16 * * * punctuation unspecified unspecified unspecified unspecified unspecified  	O	null
17 kimani kimani kimani foreign unspecified unspecified unspecified unspecified unspecified  	I_ORG	null
18 passa passa passa foreign unspecified unspecified unspecified unspecified unspecified  	I_ORG	null
19 entering entering entering foreign unspecified unspecified unspecified unspecified unspecified  	I_ORG	null
20 in in in foreign unspecified unspecified unspecified unspecified unspecified  	I_ORG	null
21 anther anther anther foreign unspecified unspecified unspecified unspecified unspecified  	I_ORG	null
22 dimension dimension dimension foreign unspecified unspecified unspecified unspecified unspecified  	I_ORG	null
23 come come come foreign unspecified unspecified unspecified unspecified unspecified  	I_ORG	null
24 on on on foreign unspecified unspecified unspecified unspecified unspecified  	I_ORG	null
25 the the the foreign unspecified unspecified unspecified unspecified unspecified  	I_ORG	null
26 flying flying flying foreign unspecified unspecified unspecified unspecified unspecified  	I_ORG	null
27 like like like foreign unspecified unspecified unspecified unspecified unspecified  	I_ORG	null
28 the the the foreign unspecified unspecified unspecified unspecified unspecified  	I_ORG	null
29 birds birds birds foreign unspecified unspecified unspecified unspecified unspecified  	I_ORG	null
30 and and and foreign unspecified unspecified unspecified unspecified unspecified  	I_ORG	null
31 something something something foreign unspecified unspecified unspecified unspecified unspecified  	I_ORG	null
32 as as as foreign unspecified unspecified unspecified unspecified unspecified  	I_ORG	null
33 me me me foreign unspecified unspecified unspecified unspecified unspecified  	I_ORG	null
34 selfish selfish selfish foreign unspecified unspecified unspecified unspecified unspecified  	I_ORG	null
35 clidoscoulping clidoscoulping clidoscoulping foreign unspecified unspecified unspecified unspecified unspecified  	I_ORG	null
36 light light light foreign unspecified unspecified unspecified unspecified unspecified  	I_ORG	null
37 a a a foreign unspecified unspecified unspecified unspecified unspecified  	I_ORG	null
38 bird bird bird foreign unspecified unspecified unspecified unspecified unspecified  	I_ORG	null
39 and and and foreign unspecified unspecified unspecified unspecified unspecified  	I_ORG	null
40 you you you foreign unspecified unspecified unspecified unspecified unspecified  	I_ORG	null
41 , , , punctuation unspecified unspecified unspecified unspecified unspecified  	O	null
42 MA MA MA foreign unspecified unspecified unspecified unspecified unspecified  	O	null
43 * * * punctuation unspecified unspecified unspecified unspecified unspecified  	O	null
44 * * * punctuation unspecified unspecified unspecified unspecified unspecified  	O	null
45 * * * punctuation unspecified unspecified unspecified unspecified unspecified  	O	null
46 * * * punctuation unspecified unspecified unspecified unspecified unspecified  	O	null
47 ( ( ( punctuation unspecified unspecified unspecified unspecified unspecified  	O	null
48 ) ) ) punctuation unspecified unspecified unspecified unspecified unspecified  	O	null
49 ( ( ( punctuation unspecified unspecified unspecified unspecified unspecified  	O	null
50 ) ) ) punctuation unspecified unspecified unspecified unspecified unspecified  	O	null
51 & & & punctuation unspecified unspecified unspecified unspecified unspecified  	O	null
52 $ $ $ noun masculine-and-feminine singular absolute unspecified unspecified  	O	null
53 ) ) ) punctuation unspecified unspecified unspecified unspecified unspecified  	O	null
54 $ $ $ noun masculine-and-feminine singular absolute unspecified unspecified  	O	null
55 ' ' ' punctuation unspecified unspecified unspecified unspecified unspecified  	O	null
56 & & & punctuation unspecified unspecified unspecified unspecified unspecified  	O	null
57 * * * punctuation unspecified unspecified unspecified unspecified unspecified  	O	null
58 * * * punctuation unspecified unspecified unspecified unspecified unspecified  	O	null
59 * * * punctuation unspecified unspecified unspecified unspecified unspecified  	O	null

0 show show show foreign unspecified unspecified unspecified unspecified unspecified  	I_ORG	null
1 i i i foreign unspecified unspecified unspecified unspecified unspecified  	I_ORG	null

0 experimentation experimentation experimentation foreign unspecified unspecified unspecified unspecified unspecified  	I_ORG	null
1 give give give foreign unspecified unspecified unspecified unspecified unspecified  	I_ORG	null
2 me me me foreign unspecified unspecified unspecified unspecified unspecified  	I_ORG	null
3 with with with foreign unspecified unspecified unspecified unspecified unspecified  	I_ORG	null
4 soul soul soul foreign unspecified unspecified unspecified unspecified unspecified  	I_ORG	null
5 some some some foreign unspecified unspecified unspecified unspecified unspecified  	I_ORG	null
6 very very very foreign unspecified unspecified unspecified unspecified unspecified  	I_ORG	null
7 strange strange strange foreign unspecified unspecified unspecified unspecified unspecified  	I_ORG	null
8 things things things foreign unspecified unspecified unspecified unspecified unspecified  	I_ORG	null
9 happen happen happen foreign unspecified unspecified unspecified unspecified unspecified  	I_ORG	null
10 all all all foreign unspecified unspecified unspecified unspecified unspecified  	I_ORG	null
11 around around around foreign unspecified unspecified unspecified unspecified unspecified  	I_ORG	null

0 guilts guilts guilts foreign unspecified unspecified unspecified unspecified unspecified  	I_ORG	null
1 coming coming coming foreign unspecified unspecified unspecified unspecified unspecified  	I_ORG	null
2 from from from foreign unspecified unspecified unspecified unspecified unspecified  	I_ORG	null
3 outside outside outside foreign unspecified unspecified unspecified unspecified unspecified  	I_ORG	null
4 and and and foreign unspecified unspecified unspecified unspecified unspecified  	I_ORG	null
5 make make make foreign unspecified unspecified unspecified unspecified unspecified  	I_ORG	null
6 you you you foreign unspecified unspecified unspecified unspecified unspecified  	I_ORG	null
7 cry cry cry foreign unspecified unspecified unspecified unspecified unspecified  	I_ORG	null
8 A A A foreign unspecified unspecified unspecified unspecified unspecified  	I_ORG	null
9 ' ' ' punctuation unspecified unspecified unspecified unspecified unspecified  	O	null
10 s s s foreign unspecified unspecified unspecified unspecified unspecified  	I_ORG	null
11 coming coming coming foreign unspecified unspecified unspecified unspecified unspecified  	I_ORG	null
12 and and and foreign unspecified unspecified unspecified unspecified unspecified  	I_ORG	null
13 going going going foreign unspecified unspecified unspecified unspecified unspecified  	I_ORG	null
14 and and and foreign unspecified unspecified unspecified unspecified unspecified  	I_ORG	null
15 thats thats thats foreign unspecified unspecified unspecified unspecified unspecified  	I_ORG	null
16 me me me foreign unspecified unspecified unspecified unspecified unspecified  	I_ORG	null
17 feel feel feel foreign unspecified unspecified unspecified unspecified unspecified  	I_ORG	null
18 soon soon soon foreign unspecified unspecified unspecified unspecified unspecified  	I_ORG	null
19 isn't isn't isn't foreign unspecified unspecified unspecified unspecified unspecified  	I_ORG	null
20 all all all foreign unspecified unspecified unspecified unspecified unspecified  	I_ORG	null
21 that that that foreign unspecified unspecified unspecified unspecified unspecified  	I_ORG	null

0 mmm mmm mmm foreign unspecified unspecified unspecified unspecified unspecified  	I_ORG	null
1 sometimes sometimes sometimes foreign unspecified unspecified unspecified unspecified unspecified  	I_ORG	null
2 i i i foreign unspecified unspecified unspecified unspecified unspecified  	I_ORG	null
3 lose lose lose foreign unspecified unspecified unspecified unspecified unspecified  	I_ORG	null
4 it it it foreign unspecified unspecified unspecified unspecified unspecified  	I_ORG	null
5 sometimes sometimes sometimes foreign unspecified unspecified unspecified unspecified unspecified  	I_ORG	null
6 i i i foreign unspecified unspecified unspecified unspecified unspecified  	I_ORG	null
7 find find find foreign unspecified unspecified unspecified unspecified unspecified  	I_ORG	null
8 it it it foreign unspecified unspecified unspecified unspecified unspecified  	I_ORG	null

0 no no no foreign unspecified unspecified unspecified unspecified unspecified  	I_ORG	null
1 matter matter matter foreign unspecified unspecified unspecified unspecified unspecified  	I_ORG	null
2 why why why foreign unspecified unspecified unspecified unspecified unspecified  	I_ORG	null
3 no no no foreign unspecified unspecified unspecified unspecified unspecified  	I_ORG	null
4 matter matter matter foreign unspecified unspecified unspecified unspecified unspecified  	I_ORG	null
5 where where where foreign unspecified unspecified unspecified unspecified unspecified  	I_ORG	null
6 say say say foreign unspecified unspecified unspecified unspecified unspecified  	I_ORG	null
7 my my my foreign unspecified unspecified unspecified unspecified unspecified  	I_ORG	null
8 slowly slowly slowly foreign unspecified unspecified unspecified unspecified unspecified  	I_ORG	null
9 it it it foreign unspecified unspecified unspecified unspecified unspecified  	I_ORG	null
10 is is is foreign unspecified unspecified unspecified unspecified unspecified  	I_ORG	null
11 becoming becoming becoming foreign unspecified unspecified unspecified unspecified unspecified  	I_ORG	null

0 well well well foreign unspecified unspecified unspecified unspecified unspecified  	I_ORG	null
1 my my my foreign unspecified unspecified unspecified unspecified unspecified  	I_ORG	null
2 friends friends friends foreign unspecified unspecified unspecified unspecified unspecified  	I_ORG	null
3 its its its foreign unspecified unspecified unspecified unspecified unspecified  	I_ORG	null
4 coming coming coming foreign unspecified unspecified unspecified unspecified unspecified  	I_ORG	null
5 around around around foreign unspecified unspecified unspecified unspecified unspecified  	I_ORG	null
6 its its its foreign unspecified unspecified unspecified unspecified unspecified  	I_ORG	null
7 not not not foreign unspecified unspecified unspecified unspecified unspecified  	I_ORG	null
8 always always always foreign unspecified unspecified unspecified unspecified unspecified  	I_ORG	null
9 strait strait strait foreign unspecified unspecified unspecified unspecified unspecified  	I_ORG	null
10 and and and foreign unspecified unspecified unspecified unspecified unspecified  	I_ORG	null
11 easy easy easy foreign unspecified unspecified unspecified unspecified unspecified  	I_ORG	null
12 to to to foreign unspecified unspecified unspecified unspecified unspecified  	I_ORG	null
13 go go go foreign unspecified unspecified unspecified unspecified unspecified  	I_ORG	null
14 bare-footing bare-footing bare-footing foreign unspecified unspecified unspecified unspecified unspecified  	I_ORG	null
15 the the the foreign unspecified unspecified unspecified unspecified unspecified  	I_ORG	null
16 unknown unknown unknown foreign unspecified unspecified unspecified unspecified unspecified  	I_ORG	null
17 field field field foreign unspecified unspecified unspecified unspecified unspecified  	I_ORG	null
18 sometimes sometimes sometimes foreign unspecified unspecified unspecified unspecified unspecified  	I_ORG	null
19 i i i foreign unspecified unspecified unspecified unspecified unspecified  	I_ORG	null
20 got got got foreign unspecified unspecified unspecified unspecified unspecified  	I_ORG	null
21 scared scared scared foreign unspecified unspecified unspecified unspecified unspecified  	I_ORG	null
22 sometimes sometimes sometimes foreign unspecified unspecified unspecified unspecified unspecified  	I_ORG	null
23 i i i foreign unspecified unspecified unspecified unspecified unspecified  	I_ORG	null
24 fall fall fall foreign unspecified unspecified unspecified unspecified unspecified  	I_ORG	null

0 mmmmm mmmmm mmmmm foreign unspecified unspecified unspecified unspecified unspecified  	O	null
1 , , , punctuation unspecified unspecified unspecified unspecified unspecified  	O	null
2 the the the foreign unspecified unspecified unspecified unspecified unspecified  	I_ORG	null
3 here here here foreign unspecified unspecified unspecified unspecified unspecified  	I_ORG	null
4 and and and foreign unspecified unspecified unspecified unspecified unspecified  	I_ORG	null
5 the the the foreign unspecified unspecified unspecified unspecified unspecified  	I_ORG	null
6 now now now foreign unspecified unspecified unspecified unspecified unspecified  	I_ORG	null
7 ... ... ... punctuation unspecified unspecified unspecified unspecified unspecified  	O	null

