0 ל ל לחן preposition unspecified unspecified unspecified unspecified unspecified 0 
0 חן חן לחן noun masculine singular absolute unspecified unspecified  	O	null
1 מילים מילה מילים noun feminine plural absolute unspecified unspecified  	O	null
2 ו ו ועיבוד conjunction unspecified unspecified unspecified unspecified unspecified 0 
2 עיבוד עיבוד ועיבוד noun masculine singular construct unspecified unspecified  	O	null
3 - - - punctuation unspecified unspecified unspecified unspecified unspecified  	O	null
4 גבריאל גבריאל גבריאל properName unspecified unspecified unspecified unspecified unspecified  	I_PERS	null
5 פישר פישר פישר properName unspecified unspecified unspecified unspecified unspecified  	I_PERS	null
6 שירה שירה שירה noun feminine singular absolute unspecified unspecified  	O	null
7 - - - punctuation unspecified unspecified unspecified unspecified unspecified  	O	null
8 גבריאל גבריאל גבריאל properName unspecified unspecified unspecified unspecified unspecified  	I_PERS	null
9 פישר פישר פישר properName unspecified unspecified unspecified unspecified unspecified  	I_PERS	null
10 ש ש שירה relativizer/subordinatingConjunction unspecified unspecified unspecified unspecified unspecified 0 
10 ירה ירה שירה verb masculine singular unspecified 3 past  	O	null
11 ליווי ליווי ליווי noun masculine singular construct unspecified unspecified  	O	null
12 - - - punctuation unspecified unspecified unspecified unspecified unspecified  	O	null
13 פסקל פסקל פסקל noun masculine singular absolute unspecified unspecified  	O	null
14 קריסטו קריסטו קריסטו preposition unspecified unspecified unspecified unspecified unspecified  	O	null
15 גיטרה גיטרה גיטרה noun feminine singular absolute unspecified unspecified  	O	null
16 חשמלית חשמלי חשמלית adjective feminine singular absolute unspecified unspecified  	O	null
17 - - - punctuation unspecified unspecified unspecified unspecified unspecified  	O	null
18 בועז בועז בועז properName unspecified unspecified unspecified unspecified unspecified  	I_PERS	null
19 ריינשרייבר ריינשרייבר ריינשרייבר properName unspecified unspecified unspecified unspecified unspecified  	I_PERS	null
20 גיטרה גיטרה גיטרה noun feminine singular absolute unspecified unspecified  	O	null
21 אקוסטית אקוסטית אקוסטית adjective feminine singular absolute unspecified unspecified  	O	null
22 - - - punctuation unspecified unspecified unspecified unspecified unspecified  	O	null
23 איציק איציק איציק properName unspecified unspecified unspecified unspecified unspecified  	I_PERS	null
24 יונה יון יונה properName unspecified unspecified unspecified unspecified unspecified  	I_PERS	null

0 לילה לילה לילה noun masculine singular absolute unspecified unspecified  	O	null
1 של של של shel-preposition unspecified unspecified unspecified unspecified unspecified  	O	null
2 ירח ירח ירח noun masculine singular absolute unspecified unspecified  	O	null
3 מלא מלא מלא adjective masculine singular absolute unspecified unspecified  	O	null
4 ו ו והכל conjunction unspecified unspecified unspecified unspecified unspecified 0 
4 ה ה והכל definiteArticle unspecified unspecified unspecified unspecified unspecified 0 
4 הכל כול והכל quantifier unspecified unspecified unspecified unspecified unspecified  	O	null
5 כאילו כאילו כאילו conjunction unspecified unspecified unspecified unspecified unspecified  	O	null
6 נעצר נעצר נעצר verb masculine singular unspecified 3 past  	O	null
7 מ מ מלכת preposition unspecified unspecified unspecified unspecified unspecified 0 
7 לכת לכת מלכת noun feminine singular absolute unspecified unspecified  	O	null
8 רק רק רק conjunction unspecified unspecified unspecified unspecified unspecified  	O	null
9 קולות קול קולות noun masculine plural construct unspecified unspecified  	O	null
10 חיכוך חיכוך חיכוך noun masculine singular absolute unspecified unspecified  	O	null
11 רגלי רגל רגליהם noun masculine plural absolute unspecified unspecified  
11 הם הם רגליהם possessive masculine plural unspecified 3 unspecified 0 	O	null
12 של של של shel-preposition unspecified unspecified unspecified unspecified unspecified  	O	null
13 צרצרים צרצר צרצרים noun masculine plural absolute unspecified unspecified  	O	null
14 נשמעים...,ושם נשמעים...,ושם נשמעים...,ושם verb masculine singular unspecified 2 imperative  	O	null
15 ב ב בטונים preposition unspecified unspecified unspecified unspecified unspecified 0 
15 ה ה בטונים definiteArticle unspecified unspecified unspecified unspecified unspecified 0 
15 הטונים טון בטונים noun masculine plural absolute unspecified unspecified  	O	null
16 ה ה הגבוהים definiteArticle unspecified unspecified unspecified unspecified unspecified 0 
16 הגבוהים גבוה הגבוהים adjective masculine plural absolute unspecified unspecified  	O	null
17 ... ... ... punctuation unspecified unspecified unspecified unspecified unspecified  	O	null
18 אני אני אני noun masculine singular absolute unspecified unspecified  	O	null
19 עף,..אלייך עף,..אלייך עף,..אלייך verb feminine singular unspecified 2 imperative  	O	null

0 עמוק עמוק עמוק adjective masculine singular absolute unspecified unspecified  	O	null
1 עמוק עמוק עמוק adjective masculine singular absolute unspecified unspecified  	O	null
2 ב ב בתוך preposition unspecified unspecified unspecified unspecified unspecified 0 
2 תוך תוך בתוך noun masculine singular construct unspecified unspecified  	O	null
3 ה ה הלילה definiteArticle unspecified unspecified unspecified unspecified unspecified 0 
3 הלילה לילה הלילה noun masculine singular absolute unspecified unspecified  	O	null
4 ב ב במימד preposition unspecified unspecified unspecified unspecified unspecified 0 
4 מימד ממד במימד noun masculine singular absolute unspecified unspecified  	O	null
5 אחר אחר אחר adjective masculine singular absolute unspecified unspecified  	O	null
6 בכלל בכלל בכלל adverb unspecified unspecified unspecified unspecified unspecified  	O	null
7 שם שם שם adverb unspecified unspecified unspecified unspecified unspecified  	O	null
8 את את את at-preposition unspecified unspecified unspecified unspecified unspecified  	O	null
9 נמה נם נמה verb feminine singular unspecified any beinoni  	O	null
10 את את את at-preposition unspecified unspecified unspecified unspecified unspecified  	O	null
11 שנת שינה שנתך noun feminine singular absolute unspecified unspecified  
11 ך ך שנתך possessive feminine singular unspecified 2 unspecified 0 	O	null
12 ו ו וחולמת conjunction unspecified unspecified unspecified unspecified unspecified 0 
12 חולמת חלם וחולמת verb feminine singular unspecified any beinoni  	O	null
13 או או או conjunction unspecified unspecified unspecified unspecified unspecified  	O	null
14 לא לא לא negation unspecified unspecified unspecified unspecified unspecified  	O	null
15 חולמת חלם חולמת verb feminine singular unspecified any beinoni  	O	null
16 , , , punctuation unspecified unspecified unspecified unspecified unspecified  	O	null
17 שנת שינה שנת noun feminine singular construct unspecified unspecified  	O	null
18 יופי יופי יופי noun masculine singular absolute unspecified unspecified  	O	null
19 , , , punctuation unspecified unspecified unspecified unspecified unspecified  	O	null
20 שנת שינה שנת noun feminine singular construct unspecified unspecified  	O	null
21 יופי יופי יופי noun masculine singular absolute unspecified unspecified  	O	null

0 פשוט פשוט פשוט adverb unspecified unspecified unspecified unspecified unspecified  	O	null
1 לפרוש פרש לפרוש verb unspecified unspecified unspecified unspecified infinitive  	O	null
2 ידיים יד ידיים noun feminine plural absolute unspecified unspecified  	O	null
3 ל ל לצדדים preposition unspecified unspecified unspecified unspecified unspecified 0 
3 ה ה לצדדים definiteArticle unspecified unspecified unspecified unspecified unspecified 0 
3 הצדדים צד לצדדים noun masculine plural absolute unspecified unspecified  	O	null
4 לעצום עצם לעצום verb unspecified unspecified unspecified unspecified infinitive  	O	null
5 עיניים עין עיניים noun feminine plural absolute unspecified unspecified  	O	null
6 לראות ראה לראות verb unspecified unspecified unspecified unspecified infinitive  	O	null
7 ב ב בעננים preposition unspecified unspecified unspecified unspecified unspecified 0 
7 ה ה בעננים definiteArticle unspecified unspecified unspecified unspecified unspecified 0 
7 העננים ענן בעננים noun masculine plural absolute unspecified unspecified  	O	null
8 את את את at-preposition unspecified unspecified unspecified unspecified unspecified  	O	null
9 ה ה השמיים definiteArticle unspecified unspecified unspecified unspecified unspecified 0 
9 השמיים שמיים השמיים noun masculine plural absolute unspecified unspecified  	O	null
10 לראות ראה לראות verb unspecified unspecified unspecified unspecified infinitive  	O	null
11 בתוך בתוך בתוך preposition unspecified unspecified unspecified unspecified unspecified  	O	null
12 ה ה העיניים definiteArticle unspecified unspecified unspecified unspecified unspecified 0 
12 העיניים עין העיניים noun feminine plural absolute unspecified unspecified  	O	null
13 של של שלך shel-preposition unspecified unspecified unspecified unspecified unspecified  
13 ך ך שלך pronomial masculine singular unspecified 2 unspecified 0 	O	null
14 ש ש שלי... relativizer/subordinatingConjunction unspecified unspecified unspecified unspecified unspecified 0 
14 לי... לי... שלי... adjective masculine singular construct unspecified unspecified  	O	null

0 It It It foreign unspecified unspecified unspecified unspecified unspecified  	I_ORG	null
1 is is is foreign unspecified unspecified unspecified unspecified unspecified  	I_ORG	null
2 the the the foreign unspecified unspecified unspecified unspecified unspecified  	I_ORG	null
3 endless endless endless foreign unspecified unspecified unspecified unspecified unspecified  	I_ORG	null
4 nights nights nights foreign unspecified unspecified unspecified unspecified unspecified  	I_ORG	null
5 in in in foreign unspecified unspecified unspecified unspecified unspecified  	I_ORG	null
6 a a a foreign unspecified unspecified unspecified unspecified unspecified  	I_ORG	null
7 serpent serpent serpent foreign unspecified unspecified unspecified unspecified unspecified  	I_ORG	null
8 of of of foreign unspecified unspecified unspecified unspecified unspecified  	I_ORG	null
9 time time time foreign unspecified unspecified unspecified unspecified unspecified  	I_ORG	null
10 Sitting Sitting Sitting foreign unspecified unspecified unspecified unspecified unspecified  	I_ORG	null
11 in in in foreign unspecified unspecified unspecified unspecified unspecified  	I_ORG	null
12 a a a foreign unspecified unspecified unspecified unspecified unspecified  	I_ORG	null
13 place place place foreign unspecified unspecified unspecified unspecified unspecified  	I_ORG	null
14 so so so foreign unspecified unspecified unspecified unspecified unspecified  	I_ORG	null
15 far far far foreign unspecified unspecified unspecified unspecified unspecified  	I_ORG	null
16 , , , punctuation unspecified unspecified unspecified unspecified unspecified  	O	null
17 Far Far Far foreign unspecified unspecified unspecified unspecified unspecified  	I_ORG	null
18 away away away foreign unspecified unspecified unspecified unspecified unspecified  	I_ORG	null
19 behind behind behind foreign unspecified unspecified unspecified unspecified unspecified  	I_ORG	null
20 in in in foreign unspecified unspecified unspecified unspecified unspecified  	I_ORG	null
21 my my my foreign unspecified unspecified unspecified unspecified unspecified  	I_ORG	null
22 mind mind mind foreign unspecified unspecified unspecified unspecified unspecified  	I_ORG	null
23 i i i foreign unspecified unspecified unspecified unspecified unspecified  	I_ORG	null
24 am am am foreign unspecified unspecified unspecified unspecified unspecified  	I_ORG	null
25 with with with foreign unspecified unspecified unspecified unspecified unspecified  	I_ORG	null
26 you you you foreign unspecified unspecified unspecified unspecified unspecified  	I_ORG	null
27 flying flying flying foreign unspecified unspecified unspecified unspecified unspecified  	I_ORG	null
28 to to to foreign unspecified unspecified unspecified unspecified unspecified  	I_ORG	null
29 the the the foreign unspecified unspecified unspecified unspecified unspecified  	I_ORG	null
30 skies skies skies foreign unspecified unspecified unspecified unspecified unspecified  	I_ORG	null
31 Seeing Seeing Seeing foreign unspecified unspecified unspecified unspecified unspecified  	I_ORG	null
32 it it it foreign unspecified unspecified unspecified unspecified unspecified  	I_ORG	null
33 in in in foreign unspecified unspecified unspecified unspecified unspecified  	I_ORG	null
34 my my my foreign unspecified unspecified unspecified unspecified unspecified  	I_ORG	null
35 eyes eyes eyes foreign unspecified unspecified unspecified unspecified unspecified  	I_ORG	null
36 R R R foreign unspecified unspecified unspecified unspecified unspecified  	I_ORG	null
37 E E E foreign unspecified unspecified unspecified unspecified unspecified  	I_ORG	null
38 F F F foreign unspecified unspecified unspecified unspecified unspecified  	I_ORG	null
39 L L L foreign unspecified unspecified unspecified unspecified unspecified  	I_ORG	null
40 E E E foreign unspecified unspecified unspecified unspecified unspecified  	I_ORG	null
41 C C C foreign unspecified unspecified unspecified unspecified unspecified  	I_ORG	null
42 T T T foreign unspecified unspecified unspecified unspecified unspecified  	I_ORG	null
43 I I I foreign unspecified unspecified unspecified unspecified unspecified  	I_ORG	null
44 O O O foreign unspecified unspecified unspecified unspecified unspecified  	I_ORG	null
45 N N N foreign unspecified unspecified unspecified unspecified unspecified  	I_ORG	null

