0 בָּרֵך בָּרֵך בָּרֵך properName unspecified unspecified unspecified unspecified unspecified  	I_PERS	null
1 ְ ְ ְ punctuation unspecified unspecified unspecified unspecified unspecified  	O	null
2 עָלֵינו עָלֵינו עָלֵינו properName unspecified unspecified unspecified unspecified unspecified  	I_PERS	null
3 ּ ּ ּ punctuation unspecified unspecified unspecified unspecified unspecified  	O	null
4 יְהוָה יְהוָה יְהוָה properName unspecified unspecified unspecified unspecified unspecified  	I_PERS	null
5 אֱלֹהֵינו אֱלֹהֵינו אֱלֹהֵינו properName unspecified unspecified unspecified unspecified unspecified  	I_PERS	null
6 ּ ּ ּ punctuation unspecified unspecified unspecified unspecified unspecified  	O	null
7 אֶת אֶת אֶת properName unspecified unspecified unspecified unspecified unspecified  	I_PERS	null
8 הַשָּׁנָה הַשָּׁנָה הַשָּׁנָה verb feminine singular unspecified 2 imperative  	O	null
9 ה ה הַזֹּאת definiteArticle unspecified unspecified unspecified unspecified unspecified 0 
9 הַזֹּאת הַזֹּאת הַזֹּאת participle feminine singular absolute any unspecified  	I_ORG	null
10 . . . punctuation unspecified unspecified unspecified unspecified unspecified  	O	null

0 וְאֶת וְאֶת וְאֶת noun masculine-and-feminine singular absolute unspecified unspecified  	O	null
1 כָּל כָּל כָּל properName unspecified unspecified unspecified unspecified unspecified  	I_PERS	null
2 ־ ־ ־ punctuation unspecified unspecified unspecified unspecified unspecified  	O	null
3 מִינֵי מִינֵי מִינֵי properName unspecified unspecified unspecified unspecified unspecified  	I_PERS	null
4 תְּבוּאָתָה תְּבוּאָתָה תְּבוּאָתָה verb masculine-and-feminine plural unspecified 2 imperative  	O	null
5 ּ ּ ּ punctuation unspecified unspecified unspecified unspecified unspecified  	O	null
6 לְטוֹבָה לְטוֹבָה לְטוֹבָה properName unspecified unspecified unspecified unspecified unspecified  	I_PERS	null
7 . . . punctuation unspecified unspecified unspecified unspecified unspecified  	O	null

0 וְתֵן וְתֵן וְתֵן adjective masculine singular construct unspecified unspecified  	O	null
1 טַל טַל טַל adjective masculine singular construct unspecified unspecified  	O	null
2 וּמָטָר וּמָטָר וּמָטָר adjective masculine singular construct unspecified unspecified  	O	null
3 ל ל לִבְרָכָה preposition unspecified unspecified unspecified unspecified unspecified 0 
3 ִבְרָכָה ִבְרָכָה לִבְרָכָה adjective masculine singular construct unspecified unspecified  	O	null
4 עַ עַ עַל noun masculine singular absolute unspecified unspecified  
4 ו ו עַל possessive masculine singular unspecified 3 unspecified 0 	O	null
5 כָּל כָּל כָּל properName unspecified unspecified unspecified unspecified unspecified  	I_PERS	null
6 ־ ־ ־ punctuation unspecified unspecified unspecified unspecified unspecified  	O	null
7 פְּנֵי פְּנֵי פְּנֵי properName unspecified unspecified unspecified unspecified unspecified  	I_PERS	null
8 הָאֲדָמָה הָאֲדָמָה הָאֲדָמָה verb masculine-and-feminine plural unspecified 2 imperative  	O	null
9 . . . punctuation unspecified unspecified unspecified unspecified unspecified  	O	null

0 וְרַוֵּה וְרַוֵּה וְרַוֵּה properName unspecified unspecified unspecified unspecified unspecified  	I_PERS	null
1 פְּנֵי פְּנֵי פְּנֵי properName unspecified unspecified unspecified unspecified unspecified  	I_PERS	null
2 תֵבֵל תֵבֵל תֵבֵל properName unspecified unspecified unspecified unspecified unspecified  	I_PERS	null
3 ו ו וְשַׁבַּע conjunction unspecified unspecified unspecified unspecified unspecified 0 
3 ְשַׁבַּע ְשַׁבַּע וְשַׁבַּע adjective masculine singular construct unspecified unspecified  	O	null
4 אֶת אֶת אֶת adverb unspecified unspecified unspecified unspecified unspecified  	O	null
5 הָעוֹלָם הָעוֹלָם הָעוֹלָם noun feminine plural construct unspecified unspecified  	O	null
6 כֻּלּו כֻּלּו כֻּלּו adjective masculine singular construct unspecified unspecified  	O	null
7 ֹ ֹ ֹ punctuation unspecified unspecified unspecified unspecified unspecified  	O	null
8 מִטּוּבָך מִטּוּבָך מִטּוּבָך properName unspecified unspecified unspecified unspecified unspecified  	I_PERS	null
9 ְ ְ ְ punctuation unspecified unspecified unspecified unspecified unspecified  	O	null
10 . . . punctuation unspecified unspecified unspecified unspecified unspecified  	O	null

0 וּמַלֵּא וּמַלֵּא וּמַלֵּא properName unspecified unspecified unspecified unspecified unspecified  	I_PERS	null
1 יָדֵינו יָדֵינו יָדֵינו verb masculine-and-feminine plural unspecified 2 imperative  	O	null
2 ּ ּ ּ punctuation unspecified unspecified unspecified unspecified unspecified  	O	null
3 מִבִּרְכוֹתֶיך מִבִּרְכוֹתֶיך מִבִּרְכוֹתֶיך adjective masculine singular construct unspecified unspecified  	O	null
4 ָ ָ ָ punctuation unspecified unspecified unspecified unspecified unspecified  	O	null
5 וּמֵעֹשֶׁר וּמֵעֹשֶׁר וּמֵעֹשֶׁר properName unspecified unspecified unspecified unspecified unspecified  	I_PERS	null
6 מַתְּנוֹת מַתְּנוֹת מַתְּנוֹת properName unspecified unspecified unspecified unspecified unspecified  	I_PERS	null
7 יָדֶיך יָדֶיך יָדֶיך verb masculine plural unspecified any beinoni  	O	null
8 ָ ָ ָ punctuation unspecified unspecified unspecified unspecified unspecified  	O	null
9 . . . punctuation unspecified unspecified unspecified unspecified unspecified  	O	null

0 שָׁמְרָה שָׁמְרָה שָׁמְרָה adjective masculine singular construct unspecified unspecified  	O	null
1 וְהַצִּילָה וְהַצִּילָה וְהַצִּילָה adjective masculine singular construct unspecified unspecified  	O	null
2 ש ש שָׁנָה relativizer/subordinatingConjunction unspecified unspecified unspecified unspecified unspecified 0 
2 ָׁנָה ָׁנָה שָׁנָה adjective masculine singular construct unspecified unspecified  	O	null
3 זו זו זו pronoun feminine singular unspecified 3 unspecified  	O	null
4 ֹ ֹ ֹ punctuation unspecified unspecified unspecified unspecified unspecified  	O	null
5 מִכָּל מִכָּל מִכָּל adjective masculine singular construct unspecified unspecified  	O	null
6 ־ ־ ־ punctuation unspecified unspecified unspecified unspecified unspecified  	O	null
7 דָּבָּר דָּבָּר דָּבָּר verb masculine singular unspecified 2 imperative  	O	null
8 רּע רּע רּע properName unspecified unspecified unspecified unspecified unspecified  	I_PERS	null
9 . . . punctuation unspecified unspecified unspecified unspecified unspecified  	O	null

0 וּמִכָּל וּמִכָּל וּמִכָּל properName unspecified unspecified unspecified unspecified unspecified  	I_PERS	null
1 ־ ־ ־ punctuation unspecified unspecified unspecified unspecified unspecified  	O	null
2 מִינֵי מִינֵי מִינֵי properName unspecified unspecified unspecified unspecified unspecified  	I_PERS	null
3 מַשְׁחִית מַשְׁחִית מַשְׁחִית verb feminine singular unspecified 2 past  	O	null
4 וּמִכָּל וּמִכָּל וּמִכָּל verb feminine singular unspecified 2 imperative  	O	null
5 ־ ־ ־ punctuation unspecified unspecified unspecified unspecified unspecified  	O	null
6 מִינֵי מִינֵי מִינֵי adjective masculine plural construct unspecified unspecified  	O	null
7 פּוּרְעָנוּת פּוּרְעָנוּת פּוּרְעָנוּת adjective masculine singular construct unspecified unspecified  	O	null
8 . . . punctuation unspecified unspecified unspecified unspecified unspecified  	O	null

0 וַעֲשֵׂה וַעֲשֵׂה וַעֲשֵׂה verb feminine singular unspecified 2 imperative  	O	null
1 ל ל לָה preposition unspecified unspecified unspecified unspecified unspecified 0 
1 ָ ָ לָה noun feminine singular absolute unspecified unspecified  
1 י י לָה possessive masculine-and-feminine singular unspecified 1 unspecified 0 	O	null
2 ּ ּ ּ punctuation unspecified unspecified unspecified unspecified unspecified  	O	null
3 תִּקְוָה תִּקְוָה תִּקְוָה properName unspecified unspecified unspecified unspecified unspecified  	I_PERS	null
4 טוֹבה טוֹבה טוֹבה verb feminine singular unspecified any beinoni  	O	null
5 ואַחֲרִית ואַחֲרִית ואַחֲרִית properName unspecified unspecified unspecified unspecified unspecified  	I_PERS	null
6 שָׁלוֹם שָׁלוֹם שָׁלוֹם properName unspecified unspecified unspecified unspecified unspecified  	I_PERS	null
7 . . . punctuation unspecified unspecified unspecified unspecified unspecified  	O	null

0 חוּס חוּס חוּס properName unspecified unspecified unspecified unspecified unspecified  	I_PERS	null
1 וְרַחֵם וְרַחֵם וְרַחֵם properName unspecified unspecified unspecified unspecified unspecified  	I_PERS	null
2 עָלֶיה עָלֶיה עָלֶיה properName unspecified unspecified unspecified unspecified unspecified  	I_PERS	null
3 ָ ָ ָ punctuation unspecified unspecified unspecified unspecified unspecified  	O	null
4 ו ו וְעַל conjunction unspecified unspecified unspecified unspecified unspecified 0 
4 ְעַל ְעַל וְעַל adjective masculine singular construct unspecified unspecified  	O	null
5 כָּל כָּל כָּל properName unspecified unspecified unspecified unspecified unspecified  	I_ORG	null
6 ־ ־ ־ punctuation unspecified unspecified unspecified unspecified unspecified  	O	null
7 תְּבוּאָתָה תְּבוּאָתָה תְּבוּאָתָה properName unspecified unspecified unspecified unspecified unspecified  	I_PERS	null
8 ּ ּ ּ punctuation unspecified unspecified unspecified unspecified unspecified  	O	null
9 וּפֵירוֹתֶיה וּפֵירוֹתֶיה וּפֵירוֹתֶיה properName unspecified unspecified unspecified unspecified unspecified  	I_PERS	null
10 ָ ָ ָ punctuation unspecified unspecified unspecified unspecified unspecified  	O	null
11 . . . punctuation unspecified unspecified unspecified unspecified unspecified  	O	null

0 ו ו וּבָרְכָה conjunction unspecified unspecified unspecified unspecified unspecified 0 
0 ּבָרְכָה ּבָרְכָה וּבָרְכָה adjective masculine singular construct unspecified unspecified  	O	null
1 ּ ּ ּ punctuation unspecified unspecified unspecified unspecified unspecified  	O	null
2 בְּגִשְׁמֵי בְּגִשְׁמֵי בְּגִשְׁמֵי properName unspecified unspecified unspecified unspecified unspecified  	I_PERS	null
3 רָצוֹן רָצוֹן רָצוֹן properName unspecified unspecified unspecified unspecified unspecified  	I_PERS	null
4 בְּרָכָה בְּרָכָה בְּרָכָה properName unspecified unspecified unspecified unspecified unspecified  	I_PERS	null
5 ו ו וּנְדָבָה conjunction unspecified unspecified unspecified unspecified unspecified 0 
5 ּנְדָבָה ּנְדָבָה וּנְדָבָה properName unspecified unspecified unspecified unspecified unspecified  	B_PERS	null
6 . . . punctuation unspecified unspecified unspecified unspecified unspecified  	O	null

0 ו ו וּתְהִי conjunction unspecified unspecified unspecified unspecified unspecified 0 
0 ּתְהִי ּתְהִי וּתְהִי properName unspecified unspecified unspecified unspecified unspecified  	I_PERS	null
1 אַחֲרִיתָה אַחֲרִיתָה אַחֲרִיתָה properName unspecified unspecified unspecified unspecified unspecified  	I_PERS	null
2 ּ ּ ּ punctuation unspecified unspecified unspecified unspecified unspecified  	O	null
3 חַיִּים חַיִּים חַיִּים verb masculine plural unspecified any beinoni  	O	null
4 וְשָׂבָע וְשָׂבָע וְשָׂבָע properName unspecified unspecified unspecified unspecified unspecified  	I_PERS	null
5 וְשָׁלוֹם וְשָׁלוֹם וְשָׁלוֹם properName unspecified unspecified unspecified unspecified unspecified  	I_PERS	null
6 . . . punctuation unspecified unspecified unspecified unspecified unspecified  	O	null

0 כַּשָּׁנִים כַּשָּׁנִים כַּשָּׁנִים properName unspecified unspecified unspecified unspecified unspecified  	I_PERS	null
1 הַטּוֹבוֹת הַטּוֹבוֹת הַטּוֹבוֹת verb feminine singular unspecified 2 imperative  	O	null
2 ל ל לִבְרָכָה preposition unspecified unspecified unspecified unspecified unspecified 0 
2 ִבְרָכָה ִבְרָכָה לִבְרָכָה properName unspecified unspecified unspecified unspecified unspecified  	I_LOC	null
3 . . . punctuation unspecified unspecified unspecified unspecified unspecified  	O	null

0 כִּי כִּי כִּי adjective masculine plural construct unspecified unspecified  	O	null
1 אֵ אֵ אֵל noun masculine singular absolute unspecified unspecified  
1 ו ו אֵל possessive masculine singular unspecified 3 unspecified 0 	O	null
2 טוֹב טוֹב טוֹב adjective masculine singular construct unspecified unspecified  	O	null
3 וּמֵטִיב וּמֵטִיב וּמֵטִיב properName unspecified unspecified unspecified unspecified unspecified  	I_ORG	null
4 אַתָּה אַתָּה אַתָּה properName unspecified unspecified unspecified unspecified unspecified  	I_ORG	null
5 וּמְבָרֵך וּמְבָרֵך וּמְבָרֵך properName unspecified unspecified unspecified unspecified unspecified  	I_ORG	null
6 ְ ְ ְ punctuation unspecified unspecified unspecified unspecified unspecified  	O	null
7 השָּׁנִים השָּׁנִים השָּׁנִים verb feminine singular unspecified 2 imperative  	O	null
8 . . . punctuation unspecified unspecified unspecified unspecified unspecified  	O	null

