0 ב ב ברגעים preposition unspecified unspecified unspecified unspecified unspecified 0 
0 רגעים רגע ברגעים noun masculine plural absolute unspecified unspecified  	O	null
1 ש ש שהרגשתי relativizer/subordinatingConjunction unspecified unspecified unspecified unspecified unspecified 0 
1 הרגשתי הרגיש שהרגשתי verb masculine-and-feminine singular unspecified 1 past  	O	null
2 ש ש שהכל relativizer/subordinatingConjunction unspecified unspecified unspecified unspecified unspecified 0 
2 ה ה שהכל definiteArticle unspecified unspecified unspecified unspecified unspecified 0 
2 הכל כול שהכל quantifier unspecified unspecified unspecified unspecified unspecified  	O	null
3 ב ב בי preposition unspecified unspecified unspecified unspecified unspecified  
3 י י בי pronomial masculine-and-feminine singular unspecified 1 unspecified 0 	O	null
4 נשבר נשבר נשבר verb masculine singular unspecified 3 past  	O	null
5 היית הוא היית copula feminine singular unspecified 2 past  	O	null
6 כתף כתף כתף noun feminine singular absolute unspecified unspecified  	O	null
7 ל ל לעזרי preposition unspecified unspecified unspecified unspecified unspecified 0 
7 עזרי עזר לעזרי noun masculine plural construct unspecified unspecified  	O	null
8 , , , punctuation unspecified unspecified unspecified unspecified unspecified  	O	null
9 גיליתי גילה גיליתי verb masculine-and-feminine singular unspecified 1 past  	O	null
10 את את אותך at-preposition unspecified unspecified unspecified unspecified unspecified  
10 ך ך אותך pronomial masculine singular unspecified 2 unspecified 0 	O	null
11 ו ו ואתה conjunction unspecified unspecified unspecified unspecified unspecified 0 
11 אתה הוא ואתה pronoun masculine singular unspecified 2 unspecified  	O	null
12 תמיד תמיד תמיד adverb unspecified unspecified unspecified unspecified unspecified  	O	null
13 את את איתי at-preposition unspecified unspecified unspecified unspecified unspecified  
13 י י איתי pronomial masculine-and-feminine singular unspecified 1 unspecified 0 	O	null
14 . . . punctuation unspecified unspecified unspecified unspecified unspecified  	O	null

0 I I I foreign unspecified unspecified unspecified unspecified unspecified  	O	null
1 ' ' ' punctuation unspecified unspecified unspecified unspecified unspecified  	O	null
2 ll ll ll foreign unspecified unspecified unspecified unspecified unspecified  	I_ORG	null
3 reach reach reach foreign unspecified unspecified unspecified unspecified unspecified  	I_ORG	null
4 out out out foreign unspecified unspecified unspecified unspecified unspecified  	I_ORG	null
5 my my my foreign unspecified unspecified unspecified unspecified unspecified  	I_ORG	null
6 hand hand hand foreign unspecified unspecified unspecified unspecified unspecified  	I_ORG	null
7 I I I foreign unspecified unspecified unspecified unspecified unspecified  	I_ORG	null
8 ' ' ' punctuation unspecified unspecified unspecified unspecified unspecified  	O	null
9 ll ll ll foreign unspecified unspecified unspecified unspecified unspecified  	I_ORG	null
10 have have have foreign unspecified unspecified unspecified unspecified unspecified  	I_ORG	null
11 faith faith faith foreign unspecified unspecified unspecified unspecified unspecified  	I_ORG	null
12 in in in foreign unspecified unspecified unspecified unspecified unspecified  	I_ORG	null
13 your your your foreign unspecified unspecified unspecified unspecified unspecified  	I_ORG	null
14 name name name foreign unspecified unspecified unspecified unspecified unspecified  	I_ORG	null
15 I I I foreign unspecified unspecified unspecified unspecified unspecified  	I_ORG	null
16 ' ' ' punctuation unspecified unspecified unspecified unspecified unspecified  	O	null
17 m m m foreign unspecified unspecified unspecified unspecified unspecified  	I_ORG	null
18 so so so foreign unspecified unspecified unspecified unspecified unspecified  	I_ORG	null
19 glad glad glad foreign unspecified unspecified unspecified unspecified unspecified  	I_ORG	null
20 that that that foreign unspecified unspecified unspecified unspecified unspecified  	I_ORG	null
21 I I I foreign unspecified unspecified unspecified unspecified unspecified  	I_ORG	null
22 finally finally finally foreign unspecified unspecified unspecified unspecified unspecified  	I_ORG	null
23 found found found foreign unspecified unspecified unspecified unspecified unspecified  	I_ORG	null
24 you you you foreign unspecified unspecified unspecified unspecified unspecified  	I_ORG	null
25 חיזקת חיזק חיזקת verb masculine singular unspecified 2 past  	O	null
26 את את את at-preposition unspecified unspecified unspecified unspecified unspecified  	O	null
27 דרכי דרך דרכי noun feminine plural construct unspecified unspecified  	O	null
28 אמונת אמונה אמונתי noun feminine singular absolute unspecified unspecified  
28 י י אמונתי possessive masculine-and-feminine singular unspecified 1 unspecified 0 	O	null
29 , , , punctuation unspecified unspecified unspecified unspecified unspecified  	O	null
30 ראית ראה ראית verb feminine singular unspecified 2 past  	O	null
31 את את את at-preposition unspecified unspecified unspecified unspecified unspecified  	O	null
32 ה ה הטוב definiteArticle unspecified unspecified unspecified unspecified unspecified 0 
32 הטוב טוב הטוב noun masculine singular absolute unspecified unspecified  	O	null
33 ש ש שבליבי relativizer/subordinatingConjunction unspecified unspecified unspecified unspecified unspecified 0 
33 ב ב שבליבי preposition unspecified unspecified unspecified unspecified unspecified 0 
33 ליבי ליבי שבליבי properName unspecified unspecified unspecified unspecified unspecified  	I_PERS	null

0 You You You foreign unspecified unspecified unspecified unspecified unspecified  	O	null
1 ' ' ' punctuation unspecified unspecified unspecified unspecified unspecified  	O	null
2 ve ve ve foreign unspecified unspecified unspecified unspecified unspecified  	I_ORG	null
3 been been been foreign unspecified unspecified unspecified unspecified unspecified  	I_ORG	null
4 the the the foreign unspecified unspecified unspecified unspecified unspecified  	I_ORG	null
5 truth truth truth foreign unspecified unspecified unspecified unspecified unspecified  	I_ORG	null
6 you you you foreign unspecified unspecified unspecified unspecified unspecified  	I_ORG	null
7 held held held foreign unspecified unspecified unspecified unspecified unspecified  	I_ORG	null
8 me me me foreign unspecified unspecified unspecified unspecified unspecified  	I_ORG	null
9 up up up foreign unspecified unspecified unspecified unspecified unspecified  	I_ORG	null
10 את את אתה at-preposition unspecified unspecified unspecified unspecified unspecified  
10 ה ה אתה pronomial feminine singular unspecified 3 unspecified 0 	O	null
11 ה ה הגדול definiteArticle unspecified unspecified unspecified unspecified unspecified 0 
11 הגדול גדול הגדול adjective masculine singular absolute unspecified unspecified  	O	null
12 מ מ מכולם preposition unspecified unspecified unspecified unspecified unspecified 0 
12 כולם כולם מכולם pronoun masculine plural unspecified 3 unspecified  	O	null
13 , , , punctuation unspecified unspecified unspecified unspecified unspecified  	O	null
14 חי חי חי verb masculine singular unspecified 3 past  	O	null
15 ב ב בצילך preposition unspecified unspecified unspecified unspecified unspecified 0 
15 ציל ציל בצילך noun masculine singular absolute unspecified unspecified  
15 ה ה בצילך possessive feminine singular unspecified 3 unspecified 0 	O	null
16 תחת תחת תחת preposition unspecified unspecified unspecified unspecified unspecified  	O	null
17 כנפי כנף כנפי noun feminine plural construct unspecified unspecified  	O	null
18 אמונת אמונה אמונתך noun feminine singular absolute unspecified unspecified  
18 ך ך אמונתך possessive feminine singular unspecified 2 unspecified 0 	O	null
19 . . . punctuation unspecified unspecified unspecified unspecified unspecified  	O	null

0 you you you foreign unspecified unspecified unspecified unspecified unspecified  	I_ORG	null
1 gave gave gave foreign unspecified unspecified unspecified unspecified unspecified  	I_ORG	null
2 me me me foreign unspecified unspecified unspecified unspecified unspecified  	I_ORG	null
3 strength strength strength foreign unspecified unspecified unspecified unspecified unspecified  	I_ORG	null
4 to to to foreign unspecified unspecified unspecified unspecified unspecified  	I_ORG	null
5 carry carry carry foreign unspecified unspecified unspecified unspecified unspecified  	I_ORG	null
6 on on on foreign unspecified unspecified unspecified unspecified unspecified  	I_ORG	null
7 I I I foreign unspecified unspecified unspecified unspecified unspecified  	I_ORG	null
8 ' ' ' punctuation unspecified unspecified unspecified unspecified unspecified  	O	null
9 ve ve ve foreign unspecified unspecified unspecified unspecified unspecified  	I_ORG	null
10 never never never foreign unspecified unspecified unspecified unspecified unspecified  	I_ORG	null
11 felt felt felt foreign unspecified unspecified unspecified unspecified unspecified  	I_ORG	null
12 with with with foreign unspecified unspecified unspecified unspecified unspecified  	I_ORG	null
13 you you you foreign unspecified unspecified unspecified unspecified unspecified  	I_ORG	null
14 alone alone alone foreign unspecified unspecified unspecified unspecified unspecified  	I_ORG	null
15 cause cause cause foreign unspecified unspecified unspecified unspecified unspecified  	I_ORG	null
16 your your your foreign unspecified unspecified unspecified unspecified unspecified  	I_ORG	null
17 the the the foreign unspecified unspecified unspecified unspecified unspecified  	I_ORG	null
18 voice voice voice foreign unspecified unspecified unspecified unspecified unspecified  	I_ORG	null
19 in in in foreign unspecified unspecified unspecified unspecified unspecified  	I_ORG	null
20 me me me foreign unspecified unspecified unspecified unspecified unspecified  	I_ORG	null
21 that that that foreign unspecified unspecified unspecified unspecified unspecified  	I_ORG	null
22 carries carries carries foreign unspecified unspecified unspecified unspecified unspecified  	I_ORG	null
23 on on on foreign unspecified unspecified unspecified unspecified unspecified  	I_ORG	null

0 כש כש כשהלילה temporalSubConj unspecified unspecified unspecified unspecified unspecified 0 
0 ה ה כשהלילה definiteArticle unspecified unspecified unspecified unspecified unspecified 0 
0 הלילה לילה כשהלילה noun masculine singular absolute unspecified unspecified  	O	null
1 האיר האיר האיר verb masculine singular unspecified 3 past  	O	null
2 ו ו והציף conjunction unspecified unspecified unspecified unspecified unspecified 0 
2 הציף הציף והציף verb masculine singular unspecified 3 past  	O	null
3 תהיות תהייה תהיות noun feminine plural absolute unspecified unspecified  	O	null
4 היית הוא היית copula feminine singular unspecified 2 past  	O	null
5 תשובה תשובה תשובה noun feminine singular absolute unspecified unspecified  	O	null
6 ל ל לנפשי preposition unspecified unspecified unspecified unspecified unspecified 0 
6 ה ה לנפשי definiteArticle unspecified unspecified unspecified unspecified unspecified 0 
6 הנפשי נפשי לנפשי adjective masculine singular absolute unspecified unspecified  	O	null
7 , , , punctuation unspecified unspecified unspecified unspecified unspecified  	O	null
8 ה ה הפחד definiteArticle unspecified unspecified unspecified unspecified unspecified 0 
8 הפחד פחד הפחד noun masculine singular absolute unspecified unspecified  	O	null
9 נמלט נמלט נמלט verb masculine singular unspecified 3 past  	O	null
10 ו ו והשקט conjunction unspecified unspecified unspecified unspecified unspecified 0 
10 ה ה והשקט definiteArticle unspecified unspecified unspecified unspecified unspecified 0 
10 השקט שקט והשקט noun masculine singular absolute unspecified unspecified  	O	null
11 שטף שטף שטף verb masculine singular unspecified 3 past  	O	null
12 את את את at-preposition unspecified unspecified unspecified unspecified unspecified  	O	null
13 ליבי ליבי ליבי properName unspecified unspecified unspecified unspecified unspecified  	I_PERS	null
14 . . . punctuation unspecified unspecified unspecified unspecified unspecified  	O	null

0 your your your foreign unspecified unspecified unspecified unspecified unspecified  	I_ORG	null
1 the the the foreign unspecified unspecified unspecified unspecified unspecified  	I_ORG	null
2 light light light foreign unspecified unspecified unspecified unspecified unspecified  	I_ORG	null
3 in in in foreign unspecified unspecified unspecified unspecified unspecified  	I_ORG	null
4 the the the foreign unspecified unspecified unspecified unspecified unspecified  	I_ORG	null
5 sky sky sky foreign unspecified unspecified unspecified unspecified unspecified  	I_ORG	null
6 like like like foreign unspecified unspecified unspecified unspecified unspecified  	I_ORG	null
7 a a a foreign unspecified unspecified unspecified unspecified unspecified  	I_ORG	null
8 star star star foreign unspecified unspecified unspecified unspecified unspecified  	I_ORG	null
9 I I I foreign unspecified unspecified unspecified unspecified unspecified  	I_ORG	null
10 can can can foreign unspecified unspecified unspecified unspecified unspecified  	I_ORG	null
11 shine shine shine foreign unspecified unspecified unspecified unspecified unspecified  	I_ORG	null
12 I I I foreign unspecified unspecified unspecified unspecified unspecified  	I_ORG	null
13 don't don't don't foreign unspecified unspecified unspecified unspecified unspecified  	I_ORG	null
14 want want want foreign unspecified unspecified unspecified unspecified unspecified  	I_ORG	null
15 to to to foreign unspecified unspecified unspecified unspecified unspecified  	I_ORG	null
16 lose lose lose foreign unspecified unspecified unspecified unspecified unspecified  	I_ORG	null
17 what what what foreign unspecified unspecified unspecified unspecified unspecified  	I_ORG	null
18 i i i foreign unspecified unspecified unspecified unspecified unspecified  	I_ORG	null
19 have have have foreign unspecified unspecified unspecified unspecified unspecified  	I_ORG	null
20 found found found foreign unspecified unspecified unspecified unspecified unspecified  	I_ORG	null
21 I I I foreign unspecified unspecified unspecified unspecified unspecified  	I_ORG	null
22 need need need foreign unspecified unspecified unspecified unspecified unspecified  	I_ORG	null
23 you you you foreign unspecified unspecified unspecified unspecified unspecified  	I_ORG	null
24 like like like foreign unspecified unspecified unspecified unspecified unspecified  	I_ORG	null
25 the the the foreign unspecified unspecified unspecified unspecified unspecified  	I_ORG	null
26 river river river foreign unspecified unspecified unspecified unspecified unspecified  	I_ORG	null
27 needs needs needs foreign unspecified unspecified unspecified unspecified unspecified  	I_ORG	null
28 the the the foreign unspecified unspecified unspecified unspecified unspecified  	I_ORG	null
29 rain rain rain foreign unspecified unspecified unspecified unspecified unspecified  	I_ORG	null
30 את את אתה at-preposition unspecified unspecified unspecified unspecified unspecified  
30 ה ה אתה pronomial feminine singular unspecified 3 unspecified 0 	O	null
31 אמונת אמונה אמונתי noun feminine singular absolute unspecified unspecified  
31 י י אמונתי possessive masculine-and-feminine singular unspecified 1 unspecified 0 	O	null
32 את את אתה at-preposition unspecified unspecified unspecified unspecified unspecified  
32 ה ה אתה pronomial feminine singular unspecified 3 unspecified 0 	O	null
33 מלכי מלך מלכי noun masculine plural construct unspecified unspecified  	O	null

0 You You You foreign unspecified unspecified unspecified unspecified unspecified  	O	null
1 ' ' ' punctuation unspecified unspecified unspecified unspecified unspecified  	O	null
2 ve ve ve foreign unspecified unspecified unspecified unspecified unspecified  	O	null
3 been been been foreign unspecified unspecified unspecified unspecified unspecified  	O	null
4 the the the foreign unspecified unspecified unspecified unspecified unspecified  	O	null
5 truth truth truth foreign unspecified unspecified unspecified unspecified unspecified  	O	null
6 ... ... ... punctuation unspecified unspecified unspecified unspecified unspecified  	O	null

0 שומר שומר שומר verb masculine singular unspecified 3 past  	O	null
1 את את את at-preposition unspecified unspecified unspecified unspecified unspecified  	O	null
2 דרך דרך דרכי noun feminine singular absolute unspecified unspecified  
2 י י דרכי possessive masculine-and-feminine singular unspecified 1 unspecified 0 	O	null
3 רואה ראה רואה verb masculine singular unspecified any beinoni  	O	null
4 את את את at-preposition unspecified unspecified unspecified unspecified unspecified  	O	null
5 צעדי צעד צעדי noun masculine plural construct unspecified unspecified  	O	null
6 , , , punctuation unspecified unspecified unspecified unspecified unspecified  	O	null
7 שומע שמע שומע verb masculine singular unspecified any beinoni  	O	null
8 קולי קולי קולי adjective masculine singular absolute unspecified unspecified  	O	null
9 עונה ענה עונה verb masculine singular unspecified any beinoni  	O	null
10 ל ל לתפילותי preposition unspecified unspecified unspecified unspecified unspecified 0 
10 תפילות תפילה לתפילותי noun feminine plural absolute unspecified unspecified  
10 י י לתפילותי possessive masculine-and-feminine singular unspecified 1 unspecified 0 	O	null
11 , , , punctuation unspecified unspecified unspecified unspecified unspecified  	O	null
12 ב ב בדרכך preposition unspecified unspecified unspecified unspecified unspecified 0 
12 דרך דרך בדרכך noun feminine singular absolute unspecified unspecified  
12 ך ך בדרכך possessive feminine singular unspecified 2 unspecified 0 	O	null
13 לנצח ניצח לנצח verb unspecified unspecified unspecified unspecified infinitive  	O	null
14 אחי אח אחיה noun masculine plural absolute unspecified unspecified  
14 ה ה אחיה possessive feminine singular unspecified 3 unspecified 0 	I_LOC	null
15 את את את at-preposition unspecified unspecified unspecified unspecified unspecified  	O	null
16 חיי חיים חיי noun masculine plural construct unspecified unspecified  	O	null
17 . . . punctuation unspecified unspecified unspecified unspecified unspecified  	O	null

0 With With With foreign unspecified unspecified unspecified unspecified unspecified  	I_ORG	null
1 you you you foreign unspecified unspecified unspecified unspecified unspecified  	I_ORG	null
2 I I I foreign unspecified unspecified unspecified unspecified unspecified  	I_ORG	null
3 just just just foreign unspecified unspecified unspecified unspecified unspecified  	I_ORG	null
4 know know know foreign unspecified unspecified unspecified unspecified unspecified  	I_ORG	null
5 how how how foreign unspecified unspecified unspecified unspecified unspecified  	I_ORG	null
6 to to to foreign unspecified unspecified unspecified unspecified unspecified  	I_ORG	null
7 move move move foreign unspecified unspecified unspecified unspecified unspecified  	I_ORG	null
8 on on on foreign unspecified unspecified unspecified unspecified unspecified  	I_ORG	null
9 you you you foreign unspecified unspecified unspecified unspecified unspecified  	I_ORG	null
10 make make make foreign unspecified unspecified unspecified unspecified unspecified  	I_ORG	null
11 my my my foreign unspecified unspecified unspecified unspecified unspecified  	I_ORG	null
12 life life life foreign unspecified unspecified unspecified unspecified unspecified  	I_ORG	null
13 complete complete complete foreign unspecified unspecified unspecified unspecified unspecified  	I_ORG	null
14 again again again foreign unspecified unspecified unspecified unspecified unspecified  	I_ORG	null
15 now now now foreign unspecified unspecified unspecified unspecified unspecified  	I_ORG	null
16 I I I foreign unspecified unspecified unspecified unspecified unspecified  	I_ORG	null
17 understand understand understand foreign unspecified unspecified unspecified unspecified unspecified  	I_ORG	null
18 that that that foreign unspecified unspecified unspecified unspecified unspecified  	I_ORG	null
19 you you you foreign unspecified unspecified unspecified unspecified unspecified  	I_ORG	null
20 have have have foreign unspecified unspecified unspecified unspecified unspecified  	I_ORG	null
21 been been been foreign unspecified unspecified unspecified unspecified unspecified  	I_ORG	null
22 there there there foreign unspecified unspecified unspecified unspecified unspecified  	I_ORG	null
23 all all all foreign unspecified unspecified unspecified unspecified unspecified  	I_ORG	null
24 my my my foreign unspecified unspecified unspecified unspecified unspecified  	I_ORG	null
25 life life life foreign unspecified unspecified unspecified unspecified unspecified  	I_ORG	null

