0 מזמור מזמור מזמור noun masculine singular absolute unspecified unspecified  	O	null
1 ל ל לדוד preposition unspecified unspecified unspecified unspecified unspecified 0 
1 דוד דוד לדוד properName unspecified unspecified unspecified unspecified unspecified  	I_PERS	null
2 ה' ה' ה' noun masculine singular absolute unspecified unspecified  	I_DATE	null
3 רועי רועי רועי properName masculine singular unspecified unspecified unspecified  	I_PERS	null
4 לא לא לא negation unspecified unspecified unspecified unspecified unspecified  	O	null
5 אחסר חסר אחסר verb masculine-and-feminine singular unspecified 1 future  	O	null
6 ב ב בנאות preposition unspecified unspecified unspecified unspecified unspecified 0 
6 נאות נאות בנאות adjective masculine singular absolute unspecified unspecified  	O	null
7 דשא דשא דשא noun masculine singular absolute unspecified unspecified  	O	null
8 ירביצני ירביצני ירביצני properName unspecified unspecified unspecified unspecified unspecified  	O	null
9 על על על preposition unspecified unspecified unspecified unspecified unspecified  	O	null
10 מי מים מי noun masculine plural construct unspecified unspecified  	O	null
11 מנוחות מנוחה מנוחות noun feminine plural construct unspecified unspecified  	O	null
12 ינהלני ינהלני ינהלני noun masculine plural absolute unspecified unspecified  	O	null
13 נפשי נפשי נפשי adjective masculine singular absolute unspecified unspecified  	O	null
14 ישובב שובב ישובב verb masculine singular unspecified 3 future  	O	null
15 ינחני ינחני ינחני verb unspecified unspecified unspecified unspecified infinitive  	O	null
16 ב ב במעגלי preposition unspecified unspecified unspecified unspecified unspecified 0 
16 מעגלי מעגל במעגלי noun masculine plural construct unspecified unspecified  	O	null
17 צדק צדק צדק noun masculine singular absolute unspecified unspecified  	O	null
18 למען למען למען preposition unspecified unspecified unspecified unspecified unspecified  	O	null
19 שם שם שמו noun masculine singular absolute unspecified unspecified  
19 ו ו שמו possessive masculine singular unspecified 3 unspecified 0 	O	null

0 גם גם גם conjunction unspecified unspecified unspecified unspecified unspecified  	O	null
1 כי כי כי conjunction unspecified unspecified unspecified unspecified unspecified  	O	null
2 אלך הלך אלך verb masculine-and-feminine singular unspecified 1 future  	O	null
3 ב ב בגיא preposition unspecified unspecified unspecified unspecified unspecified 0 
3 גיא גיא בגיא noun masculine singular construct unspecified unspecified  	O	null
4 צלמוות צלמוות צלמוות noun masculine singular absolute unspecified unspecified  	O	null
5 לא לא לא negation unspecified unspecified unspecified unspecified unspecified  	O	null
6 אירא אירא אירא properName unspecified unspecified unspecified unspecified unspecified  	O	null
7 רע רע רע adjective masculine singular absolute unspecified unspecified  	O	null
8 כי כי כי conjunction unspecified unspecified unspecified unspecified unspecified  	O	null
9 את את אתה at-preposition unspecified unspecified unspecified unspecified unspecified  
9 ה ה אתה pronomial feminine singular unspecified 3 unspecified 0 	O	null
10 עמדי עמד עמדי verb feminine singular unspecified 2 imperative  	O	null
11 שבט שבט שבטך noun masculine singular absolute unspecified unspecified  
11 ך ך שבטך possessive feminine singular unspecified 2 unspecified 0 	O	null
12 ו ו ומשענתך conjunction unspecified unspecified unspecified unspecified unspecified 0 
12 משענת משענת ומשענתך noun feminine singular absolute unspecified unspecified  
12 ך ך ומשענתך possessive feminine singular unspecified 2 unspecified 0 	O	null
13 המה המה המה verb masculine singular unspecified 3 past  	O	null
14 ינחמוני ינחמוני ינחמוני properName unspecified unspecified unspecified unspecified unspecified  	I_PERS	null
15 תערוך ערך תערוך verb feminine singular unspecified 3 future  	O	null
16 לפני לפני לפניי preposition unspecified unspecified unspecified unspecified unspecified  
16 י י לפניי pronomial masculine-and-feminine singular unspecified 1 unspecified 0 	O	null
17 שולחן שולחן שולחן noun masculine singular absolute unspecified unspecified  	O	null
18 נגד נגד נגד preposition unspecified unspecified unspecified unspecified unspecified  	O	null
19 צוררי צרר צורריי participle masculine plural unspecified any unspecified  
19 י י צורריי possessive masculine-and-feminine singular unspecified 1 unspecified 0 	O	null

0 דישנת דישן דישנת verb feminine singular unspecified 2 past  	O	null
1 ב ב בשמן preposition unspecified unspecified unspecified unspecified unspecified 0 
1 שמן שמן בשמן noun masculine singular construct unspecified unspecified  	O	null
2 ראשי ראש ראשי noun masculine plural construct unspecified unspecified  	O	null
3 כוס כוס כוסי noun feminine singular absolute unspecified unspecified  
3 י י כוסי possessive masculine-and-feminine singular unspecified 1 unspecified 0 	O	null
4 רוויה רווי רוויה properName unspecified unspecified unspecified unspecified unspecified  	I_PERS	null
5 אך אך אך conjunction unspecified unspecified unspecified unspecified unspecified  	O	null
6 טוב טוב טוב adverb unspecified unspecified unspecified unspecified unspecified  	O	null
7 ו ו וחסד conjunction unspecified unspecified unspecified unspecified unspecified 0 
7 חסד חסד וחסד noun masculine singular construct unspecified unspecified  	O	null
8 ירדפון ירדפון ירדפוני noun masculine singular absolute unspecified unspecified  
8 ם ם ירדפוני possessive masculine plural unspecified 3 unspecified 0 	O	null
9 כל כול כל quantifier unspecified unspecified construct unspecified unspecified  	O	null
10 ימי יום ימי noun masculine plural construct unspecified unspecified  	O	null
11 חיי חיים חיי noun masculine plural construct unspecified unspecified  	O	null
12 ו ו ושבתי conjunction unspecified unspecified unspecified unspecified unspecified 0 
12 שבתי שב ושבתי verb masculine-and-feminine singular unspecified 1 past  	O	null
13 ב ב בבית preposition unspecified unspecified unspecified unspecified unspecified 0 
13 בית בית בבית noun masculine singular construct unspecified unspecified  	O	null
14 ה' ה' ה' noun masculine singular absolute unspecified unspecified  	O	null
15 ל ל לאורך preposition unspecified unspecified unspecified unspecified unspecified 0 
15 אורך אורך לאורך noun masculine singular construct unspecified unspecified  	O	null
16 ימים יום ימים noun masculine plural absolute unspecified unspecified  	O	null

0 מזמור מזמור מזמור properName unspecified unspecified unspecified unspecified unspecified  	I_PERS	null
1 ל ל לדוד preposition unspecified unspecified unspecified unspecified unspecified 0 
1 דוד דוד לדוד properName unspecified unspecified unspecified unspecified unspecified  	I_PERS	null
2 ה ה ה definiteArticle unspecified unspecified unspecified unspecified unspecified 0 	O	null
3 ' ' ' punctuation unspecified unspecified unspecified unspecified unspecified  	O	null
4 ... ... ... punctuation unspecified unspecified unspecified unspecified unspecified  	O	null

