0 ל ל לדוד preposition unspecified unspecified unspecified unspecified unspecified 0 
0 דוד דוד לדוד properName unspecified unspecified unspecified unspecified unspecified  	I_PERS	null
1 מזמור מזמור מזמור properName unspecified unspecified unspecified unspecified unspecified  	I_PERS	null
2 לה לה לה properName unspecified unspecified unspecified unspecified unspecified  	I_PERS	null
3 ' ' ' punctuation unspecified unspecified unspecified unspecified unspecified  	O	null
4 ה ה הארץ definiteArticle unspecified unspecified unspecified unspecified unspecified 0 
4 הארץ ארץ הארץ noun feminine singular absolute unspecified unspecified  	O	null
5 ו ו ומלואה conjunction unspecified unspecified unspecified unspecified unspecified 0 
5 מלוא מלוא ומלואה noun masculine singular absolute unspecified unspecified  
5 ה ה ומלואה possessive feminine singular unspecified 3 unspecified 0 	O	null
6 תבל תבל תבל properName unspecified unspecified unspecified unspecified unspecified  	I_PERS	null
7 ו ו וישבי conjunction unspecified unspecified unspecified unspecified unspecified 0 
7 ישבי יישב וישבי verb feminine singular unspecified 2 imperative  	O	null
8 ב ב בה preposition unspecified unspecified unspecified unspecified unspecified  
8 ה ה בה pronomial feminine singular unspecified 3 unspecified 0 	O	null
9 כי כי כי conjunction unspecified unspecified unspecified unspecified unspecified  	O	null
10 הוא הוא הוא pronoun masculine singular unspecified 3 unspecified  	O	null
11 על על על preposition unspecified unspecified unspecified unspecified unspecified  	O	null
12 ימים יום ימים noun masculine plural absolute unspecified unspecified  	O	null
13 יסדה יסד יסדה verb feminine singular unspecified 3 past  	O	null
14 ו ו ועל conjunction unspecified unspecified unspecified unspecified unspecified 0 
14 על על ועל preposition unspecified unspecified unspecified unspecified unspecified  	O	null
15 נהרות נהר נהרות noun masculine plural construct unspecified unspecified  	O	null
16 יכוננה יכוננה יכוננה verb feminine plural unspecified 2 imperative  	O	null

0 ישא נשא ישא verb masculine singular unspecified 3 future  	O	null
1 ברכה ברכה ברכה properName masculine singular unspecified unspecified unspecified  	I_PERS	null
2 מאת מאת מאת preposition unspecified unspecified unspecified unspecified unspecified  	O	null
3 ה' ה' ה' noun masculine singular absolute unspecified unspecified  	O	null
4 ו ו וצדקה conjunction unspecified unspecified unspecified unspecified unspecified 0 
4 צדקה צדקה וצדקה noun feminine singular absolute unspecified unspecified  	O	null
5 מ מ מאלהי preposition unspecified unspecified unspecified unspecified unspecified 0 
5 אלהי אלהי מאלהי noun masculine singular construct unspecified unspecified  	O	null
6 ישע ישע ישעו noun masculine singular absolute unspecified unspecified  
6 ו ו ישעו possessive masculine singular unspecified 3 unspecified 0 	O	null
7 זה זה זה pronoun masculine singular unspecified 3 unspecified  	O	null
8 דור דור דור noun masculine singular construct unspecified unspecified  	O	null
9 דרשי דרש דרשיו noun masculine plural absolute unspecified unspecified  
9 ו ו דרשיו possessive masculine singular unspecified 3 unspecified 0 	O	null
10 מבקשי מבקש מבקשי noun masculine plural construct unspecified unspecified  	O	null
11 פני פנים פניך noun masculine-and-feminine plural absolute unspecified unspecified  
11 ך ך פניך possessive feminine singular unspecified 2 unspecified 0 	O	null
12 יעקב יעקב יעקב properName unspecified unspecified unspecified unspecified unspecified  	I_PERS	null
13 סלע סלע סלע properName unspecified unspecified unspecified unspecified unspecified  	I_PERS	null

0 ש ש שאו relativizer/subordinatingConjunction unspecified unspecified unspecified unspecified unspecified 0 
0 או או שאו conjunction unspecified unspecified unspecified unspecified unspecified  	O	null
1 שערים שער שערים noun masculine plural absolute unspecified unspecified  	O	null
2 ראשי ראש ראשיכם noun masculine plural absolute unspecified unspecified  
2 כם כם ראשיכם possessive masculine plural unspecified 2 unspecified 0 	O	null
3 ו ו והנשאו conjunction unspecified unspecified unspecified unspecified unspecified 0 
3 הנשאו נישא והנשאו verb masculine-and-feminine plural unspecified 2 imperative  	O	null
4 פתחי פתח פתחי properName unspecified unspecified unspecified unspecified unspecified  	I_PERS	null
5 עולם עולם עולם noun masculine singular absolute unspecified unspecified  	O	null
6 ו ו ויבוא conjunction unspecified unspecified unspecified unspecified unspecified 0 
6 יבוא ייבוא ויבוא noun masculine singular construct unspecified unspecified  	O	null
7 מלך מלך מלך noun masculine singular construct unspecified unspecified  	O	null
8 ה ה הכבוד definiteArticle unspecified unspecified unspecified unspecified unspecified 0 
8 הכבוד כבוד הכבוד noun masculine singular absolute unspecified unspecified  	O	null
9 מי מי מי interrogative unspecified unspecified unspecified unspecified unspecified  	O	null
10 הוא הוא הוא pronoun masculine singular unspecified 3 unspecified  	O	null
11 זה זה זה pronoun masculine singular unspecified 3 unspecified  	O	null
12 מי מי מי properName masculine singular unspecified unspecified unspecified  	O	null
13 הוא הוא הוא pronoun masculine singular unspecified 3 unspecified  	O	null
14 זה זה זה pronoun masculine singular unspecified 3 unspecified  	O	null
15 ה' ה' ה' noun masculine singular absolute unspecified unspecified  	O	null
16 צבאות צבא צבאות noun masculine plural absolute unspecified unspecified  	O	null
17 הוא הוא הוא pronoun masculine singular unspecified 3 unspecified  	O	null
18 מלך מלך מלך noun masculine singular construct unspecified unspecified  	O	null
19 ה ה הכבוד definiteArticle unspecified unspecified unspecified unspecified unspecified 0 
19 הכבוד כבוד הכבוד noun masculine singular absolute unspecified unspecified  	O	null

0 מי מי מי interrogative unspecified unspecified unspecified unspecified unspecified  	O	null
1 יעלה עלה יעלה verb masculine singular unspecified 3 future  	O	null
2 ב ב בהר preposition unspecified unspecified unspecified unspecified unspecified 0 
2 הר הר בהר noun masculine singular construct unspecified unspecified  	O	null
3 ה' ה' ה' noun masculine singular absolute unspecified unspecified  	O	null
4 ו ו ומי conjunction unspecified unspecified unspecified unspecified unspecified 0 
4 מי מי ומי interrogative unspecified unspecified unspecified unspecified unspecified  	O	null
5 יקום קם יקום verb masculine singular unspecified 3 future  	O	null
6 במקום במקום במקום preposition unspecified unspecified unspecified unspecified unspecified  	O	null
7 קדש קדש קדשו noun masculine singular absolute unspecified unspecified  
7 ו ו קדשו possessive masculine singular unspecified 3 unspecified 0 	O	null
8 נקי נקי נקי adjective masculine singular absolute unspecified unspecified  	O	null
9 כפים כפים כפים adjective masculine singular absolute unspecified unspecified  	O	null
10 ו ו ובר conjunction unspecified unspecified unspecified unspecified unspecified 0 
10 בר בר ובר properName unspecified unspecified unspecified unspecified unspecified  	I_PERS	null
11 לבב לבב לבב noun masculine singular construct unspecified unspecified  	O	null
12 אשר אשר אשר properName masculine singular unspecified unspecified unspecified  	I_PERS	null
13 לא לא לא negation unspecified unspecified unspecified unspecified unspecified  	O	null
14 נשא נשא נשא verb masculine singular unspecified 3 past  	O	null
15 ל ל לשוא preposition unspecified unspecified unspecified unspecified unspecified 0 
15 שוא שוא לשוא noun masculine singular absolute unspecified unspecified  	O	null
16 נפשי נפשי נפשי adjective masculine singular absolute unspecified unspecified  	O	null
17 ו ו ולא conjunction unspecified unspecified unspecified unspecified unspecified 0 
17 לא לא ולא negation unspecified unspecified unspecified unspecified unspecified  	O	null
18 נשבע נשבע נשבע verb masculine singular unspecified any beinoni  	O	null
19 ל ל למרמה preposition unspecified unspecified unspecified unspecified unspecified 0 
19 מרמה מרמה למרמה noun feminine singular absolute unspecified unspecified  	O	null

0 ישא נשא ישא verb masculine singular unspecified 3 future  	O	null
1 ברכה ברכה ברכה properName masculine singular unspecified unspecified unspecified  	I_PERS	null
2 מאת מאת מאת preposition unspecified unspecified unspecified unspecified unspecified  	O	null
3 ה' ה' ה' noun masculine singular absolute unspecified unspecified  	O	null
4 ו ו וצדקה conjunction unspecified unspecified unspecified unspecified unspecified 0 
4 צדקה צדקה וצדקה noun feminine singular absolute unspecified unspecified  	O	null
5 מ מ מאלהי preposition unspecified unspecified unspecified unspecified unspecified 0 
5 אלהי אלהי מאלהי noun masculine singular construct unspecified unspecified  	O	null
6 ישע ישע ישעו noun masculine singular absolute unspecified unspecified  
6 ו ו ישעו possessive masculine singular unspecified 3 unspecified 0 	O	null
7 זה זה זה pronoun masculine singular unspecified 3 unspecified  	O	null
8 דור דור דור noun masculine singular construct unspecified unspecified  	O	null
9 דרשי דרש דרשיו noun masculine plural absolute unspecified unspecified  
9 ו ו דרשיו possessive masculine singular unspecified 3 unspecified 0 	O	null
10 מבקשי מבקש מבקשי noun masculine plural construct unspecified unspecified  	O	null
11 פני פנים פניך noun masculine-and-feminine plural absolute unspecified unspecified  
11 ך ך פניך possessive feminine singular unspecified 2 unspecified 0 	O	null
12 יעקב יעקב יעקב properName unspecified unspecified unspecified unspecified unspecified  	I_PERS	null
13 סלע סלע סלע properName unspecified unspecified unspecified unspecified unspecified  	I_PERS	null

