0 Puncha Puncha Puncha foreign unspecified unspecified unspecified unspecified unspecified  	O	null
1 , , , punctuation unspecified unspecified unspecified unspecified unspecified  	O	null
2 puncha puncha puncha foreign unspecified unspecified unspecified unspecified unspecified  	I_ORG	null
3 la la la foreign unspecified unspecified unspecified unspecified unspecified  	I_ORG	null
4 rosa rosa rosa foreign unspecified unspecified unspecified unspecified unspecified  	I_ORG	null
5 huele huele huele foreign unspecified unspecified unspecified unspecified unspecified  	I_ORG	null
6 que que que foreign unspecified unspecified unspecified unspecified unspecified  	I_ORG	null
7 el el el foreign unspecified unspecified unspecified unspecified unspecified  	I_ORG	null
8 amor amor amor foreign unspecified unspecified unspecified unspecified unspecified  	I_ORG	null
9 muncho muncho muncho foreign unspecified unspecified unspecified unspecified unspecified  	I_ORG	null
10 duele duele duele foreign unspecified unspecified unspecified unspecified unspecified  	I_ORG	null
11 . . . punctuation unspecified unspecified unspecified unspecified unspecified  	O	null

0 Tu Tu Tu foreign unspecified unspecified unspecified unspecified unspecified  	I_ORG	null
1 no no no foreign unspecified unspecified unspecified unspecified unspecified  	I_ORG	null
2 nacites nacites nacites foreign unspecified unspecified unspecified unspecified unspecified  	I_ORG	null
3 para para para foreign unspecified unspecified unspecified unspecified unspecified  	I_ORG	null
4 mi mi mi foreign unspecified unspecified unspecified unspecified unspecified  	I_ORG	null
5 presto presto presto foreign unspecified unspecified unspecified unspecified unspecified  	I_ORG	null
6 alexate alexate alexate foreign unspecified unspecified unspecified unspecified unspecified  	I_ORG	null
7 de de de foreign unspecified unspecified unspecified unspecified unspecified  	I_ORG	null
8 mi mi mi foreign unspecified unspecified unspecified unspecified unspecified  	I_ORG	null

0 אם אם אם conjunction unspecified unspecified unspecified unspecified unspecified  	O	null
1 תבקש ביקש תבקש verb feminine singular unspecified 3 future  	O	null
2 לראות ראה לראות verb unspecified unspecified unspecified unspecified infinitive  	O	null
3 את את אותה at-preposition unspecified unspecified unspecified unspecified unspecified  
3 ה ה אותה pronomial feminine singular unspecified 3 unspecified 0 	O	null
4 תיתן נתן תיתן verb feminine singular unspecified 3 future  	O	null
5 לך הלך לך verb masculine singular unspecified 2 imperative  	O	null
6 אם אם אם conjunction unspecified unspecified unspecified unspecified unspecified  	O	null
7 תבקש ביקש תבקש verb feminine singular unspecified 3 future  	O	null
8 לגעת לגעת לגעת noun feminine singular absolute unspecified unspecified  	O	null
9 ב ב בה preposition unspecified unspecified unspecified unspecified unspecified  
9 ה ה בה pronomial feminine singular unspecified 3 unspecified 0 	O	null
10 תגיד הגיד תגיד verb feminine singular unspecified 3 future  	O	null
11 לך הלך לך verb masculine singular unspecified 2 imperative  	O	null
12 כמו כמו כמו conjunction unspecified unspecified unspecified unspecified unspecified  	O	null
13 ש ש שהים relativizer/subordinatingConjunction unspecified unspecified unspecified unspecified unspecified 0 
13 ה ה שהים definiteArticle unspecified unspecified unspecified unspecified unspecified 0 
13 הים ים שהים noun masculine singular absolute unspecified unspecified  	O	null
14 גדול גדול גדול adjective masculine singular absolute unspecified unspecified  	O	null
15 ו ו ואינו conjunction unspecified unspecified unspecified unspecified unspecified 0 
15 אינו הוא ואינו copula masculine singular unspecified 3 beinoni  	O	null
16 נגמר נגמר נגמר verb masculine singular unspecified any beinoni  	O	null
17 כך כך כך adverb unspecified unspecified unspecified unspecified unspecified  	O	null
18 ה ה הכאב definiteArticle unspecified unspecified unspecified unspecified unspecified 0 
18 הכאב כאב הכאב noun masculine singular absolute unspecified unspecified  	I_DATE	null
19 אצל אצל אצלה preposition unspecified unspecified unspecified unspecified unspecified  
19 ה ה אצלה pronomial feminine singular unspecified 3 unspecified 0 	O	null
20 נותר נותר נותר verb masculine singular unspecified 3 past  	O	null

0 זמן זמן זמן noun masculine singular absolute unspecified unspecified  	O	null
1 ש ש שעובר relativizer/subordinatingConjunction unspecified unspecified unspecified unspecified unspecified 0 
1 עובר עובר שעובר verb masculine singular unspecified 3 past  	O	null
2 אינו הוא אינו copula masculine singular unspecified 3 beinoni  	O	null
3 עוזר עזר עוזר verb masculine singular unspecified any beinoni  	O	null
4 לשכוח שכח לשכוח verb unspecified unspecified unspecified unspecified infinitive  	O	null
5 צער צער צער noun masculine singular absolute unspecified unspecified  	O	null
6 מתוק מתוק מתוק adjective masculine singular absolute unspecified unspecified  	O	null
7 ש ש שלא relativizer/subordinatingConjunction unspecified unspecified unspecified unspecified unspecified 0 
7 לא לא שלא negation unspecified unspecified unspecified unspecified unspecified  	O	null
8 נותן נתן נותן verb masculine singular unspecified any beinoni  	O	null
9 מנוח מנוח מנוח noun masculine singular absolute unspecified unspecified  	O	null
10 ו ו ואתה conjunction unspecified unspecified unspecified unspecified unspecified 0 
10 את את ואתה at-preposition unspecified unspecified unspecified unspecified unspecified  
10 ה ה ואתה pronomial feminine singular unspecified 3 unspecified 0 	O	null
11 היכן היכן היכן interrogative unspecified unspecified unspecified unspecified unspecified  	O	null
12 ש ש שאתה relativizer/subordinatingConjunction unspecified unspecified unspecified unspecified unspecified 0 
12 אתה הוא שאתה pronoun masculine singular unspecified 2 unspecified  	O	null
13 שוב שוב שוב adverb unspecified unspecified unspecified unspecified unspecified  	O	null
14 אל אל אל negation unspecified unspecified unspecified unspecified unspecified  	O	null
15 תברח ברח תברח verb feminine singular unspecified 3 future  	O	null
16 מ מ מאהבה preposition unspecified unspecified unspecified unspecified unspecified 0 
16 אהבה אהבה מאהבה noun feminine singular absolute unspecified unspecified  	O	null

0 שוב שוב שוב noun masculine singular construct unspecified unspecified  	O	null
1 ה ה התמונות definiteArticle unspecified unspecified unspecified unspecified unspecified 0 
1 התמונות תמונה התמונות noun feminine plural absolute unspecified unspecified  	O	null
2 ש ש שאת relativizer/subordinatingConjunction unspecified unspecified unspecified unspecified unspecified 0 
2 את את שאת at-preposition unspecified unspecified unspecified unspecified unspecified  	O	null
3 נפש נפש נפשה noun feminine singular absolute unspecified unspecified  
3 ה ה נפשה possessive feminine singular unspecified 3 unspecified 0 	O	null
4 עכשיו עכשיו עכשיו adverb unspecified unspecified unspecified unspecified unspecified  	O	null
5 פוצעות פצע פוצעות participle feminine plural construct any unspecified  	O	null
6 שוב שוב שוב noun masculine singular construct unspecified unspecified  	O	null
7 ה ה המילים definiteArticle unspecified unspecified unspecified unspecified unspecified 0 
7 המילים מילה המילים noun feminine plural absolute unspecified unspecified  	O	null
8 ש ש שאת relativizer/subordinatingConjunction unspecified unspecified unspecified unspecified unspecified 0 
8 את את שאת at-preposition unspecified unspecified unspecified unspecified unspecified  	O	null
9 ליבה ליבה ליבה noun feminine singular absolute unspecified unspecified  	O	null
10 עכשיו עכשיו עכשיו adverb unspecified unspecified unspecified unspecified unspecified  	O	null
11 דוקרות דקר דוקרות verb feminine plural unspecified any beinoni  	O	null
12 היא הוא היא pronoun feminine singular unspecified 3 unspecified  	O	null
13 מבקשת ביקש מבקשת verb feminine singular unspecified any beinoni  	O	null
14 רק רק רק conjunction unspecified unspecified unspecified unspecified unspecified  	O	null
15 נחמה נחמה נחמה noun feminine singular absolute unspecified unspecified  	O	null
16 יש יש יש existential unspecified unspecified unspecified unspecified unspecified  	O	null
17 ל ל לה preposition unspecified unspecified unspecified unspecified unspecified  
17 ה ה לה pronomial feminine singular unspecified 3 unspecified 0 	O	null
18 ה ה הכול definiteArticle unspecified unspecified unspecified unspecified unspecified 0 
18 הכול כול הכול quantifier unspecified unspecified unspecified unspecified unspecified  	O	null
19 אך אך אך conjunction unspecified unspecified unspecified unspecified unspecified  	O	null
20 לא לא לא negation unspecified unspecified unspecified unspecified unspecified  	O	null
21 את את אותך at-preposition unspecified unspecified unspecified unspecified unspecified  
21 ך ך אותך pronomial masculine singular unspecified 2 unspecified 0 	O	null

