0 Shoo Shoo Shoo foreign unspecified unspecified unspecified unspecified unspecified  	O	null
1 - - - punctuation unspecified unspecified unspecified unspecified unspecified  	O	null
2 bop bop bop foreign unspecified unspecified unspecified unspecified unspecified  	O	null
3 , , , punctuation unspecified unspecified unspecified unspecified unspecified  	O	null
4 shoo shoo shoo foreign unspecified unspecified unspecified unspecified unspecified  	O	null
5 - - - punctuation unspecified unspecified unspecified unspecified unspecified  	O	null
6 bop bop bop foreign unspecified unspecified unspecified unspecified unspecified  	O	null
7 , , , punctuation unspecified unspecified unspecified unspecified unspecified  	O	null
8 my my my foreign unspecified unspecified unspecified unspecified unspecified  	O	null
9 baby baby baby foreign unspecified unspecified unspecified unspecified unspecified  	O	null
10 Shoo Shoo Shoo foreign unspecified unspecified unspecified unspecified unspecified  	O	null
11 - - - punctuation unspecified unspecified unspecified unspecified unspecified  	O	null
12 bop bop bop foreign unspecified unspecified unspecified unspecified unspecified  	O	null
13 , , , punctuation unspecified unspecified unspecified unspecified unspecified  	O	null
14 shoo-bop…..hello shoo-bop…..hello shoo-bop…..hello foreign unspecified unspecified unspecified unspecified unspecified  	I_ORG	null
15 stranger stranger stranger foreign unspecified unspecified unspecified unspecified unspecified  	I_ORG	null
16 It It It foreign unspecified unspecified unspecified unspecified unspecified  	I_ORG	null
17 seems seems seems foreign unspecified unspecified unspecified unspecified unspecified  	I_ORG	null
18 so so so foreign unspecified unspecified unspecified unspecified unspecified  	I_ORG	null
19 good good good foreign unspecified unspecified unspecified unspecified unspecified  	I_ORG	null
20 to to to foreign unspecified unspecified unspecified unspecified unspecified  	I_ORG	null
21 see see see foreign unspecified unspecified unspecified unspecified unspecified  	I_ORG	null
22 you you you foreign unspecified unspecified unspecified unspecified unspecified  	I_ORG	null
23 back back back foreign unspecified unspecified unspecified unspecified unspecified  	I_ORG	null
24 again again again foreign unspecified unspecified unspecified unspecified unspecified  	I_ORG	null
25 … … … punctuation unspecified unspecified unspecified unspecified unspecified  	O	null
26 How How How foreign unspecified unspecified unspecified unspecified unspecified  	I_ORG	null
27 long long long foreign unspecified unspecified unspecified unspecified unspecified  	I_ORG	null
28 has has has foreign unspecified unspecified unspecified unspecified unspecified  	I_ORG	null
29 it it it foreign unspecified unspecified unspecified unspecified unspecified  	I_ORG	null
30 been been been foreign unspecified unspecified unspecified unspecified unspecified  	I_ORG	null
31 ? ? ? punctuation unspecified unspecified unspecified unspecified unspecified  	O	null

0 seems seems seems foreign unspecified unspecified unspecified unspecified unspecified  	I_ORG	null
1 like like like foreign unspecified unspecified unspecified unspecified unspecified  	I_ORG	null
2 a a a foreign unspecified unspecified unspecified unspecified unspecified  	I_ORG	null
3 mighty mighty mighty foreign unspecified unspecified unspecified unspecified unspecified  	I_ORG	null
4 long long long foreign unspecified unspecified unspecified unspecified unspecified  	I_ORG	null
5 time time time foreign unspecified unspecified unspecified unspecified unspecified  	I_ORG	null
6 , , , punctuation unspecified unspecified unspecified unspecified unspecified  	O	null
7 Shoo Shoo Shoo foreign unspecified unspecified unspecified unspecified unspecified  	O	null
8 - - - punctuation unspecified unspecified unspecified unspecified unspecified  	O	null
9 bop bop bop foreign unspecified unspecified unspecified unspecified unspecified  	O	null
10 , , , punctuation unspecified unspecified unspecified unspecified unspecified  	O	null
11 shoo shoo shoo foreign unspecified unspecified unspecified unspecified unspecified  	O	null
12 - - - punctuation unspecified unspecified unspecified unspecified unspecified  	O	null
13 bop bop bop foreign unspecified unspecified unspecified unspecified unspecified  	O	null
14 , , , punctuation unspecified unspecified unspecified unspecified unspecified  	O	null
15 my my my foreign unspecified unspecified unspecified unspecified unspecified  	I_ORG	null
16 baby baby baby foreign unspecified unspecified unspecified unspecified unspecified  	I_ORG	null
17 It It It foreign unspecified unspecified unspecified unspecified unspecified  	I_ORG	null
18 seems seems seems foreign unspecified unspecified unspecified unspecified unspecified  	I_ORG	null
19 like like like foreign unspecified unspecified unspecified unspecified unspecified  	I_ORG	null
20 a a a foreign unspecified unspecified unspecified unspecified unspecified  	I_ORG	null
21 mighty mighty mighty foreign unspecified unspecified unspecified unspecified unspecified  	I_ORG	null
22 long long long foreign unspecified unspecified unspecified unspecified unspecified  	I_ORG	null
23 time time time foreign unspecified unspecified unspecified unspecified unspecified  	I_ORG	null
24 . . . punctuation unspecified unspecified unspecified unspecified unspecified  	O	null

0 Ahhh Ahhh Ahhh foreign unspecified unspecified unspecified unspecified unspecified  	O	null
1 , , , punctuation unspecified unspecified unspecified unspecified unspecified  	O	null
2 my my my foreign unspecified unspecified unspecified unspecified unspecified  	I_ORG	null
3 my my my foreign unspecified unspecified unspecified unspecified unspecified  	I_ORG	null
4 my my my foreign unspecified unspecified unspecified unspecified unspecified  	I_ORG	null
5 my my my foreign unspecified unspecified unspecified unspecified unspecified  	I_ORG	null
6 I I I foreign unspecified unspecified unspecified unspecified unspecified  	I_ORG	null
7 ' ' ' punctuation unspecified unspecified unspecified unspecified unspecified  	O	null
8 m m m foreign unspecified unspecified unspecified unspecified unspecified  	O	null
9 so so so foreign unspecified unspecified unspecified unspecified unspecified  	O	null
10 glad glad glad foreign unspecified unspecified unspecified unspecified unspecified  	O	null
11 , , , punctuation unspecified unspecified unspecified unspecified unspecified  	O	null
12 You You You foreign unspecified unspecified unspecified unspecified unspecified  	I_ORG	null
13 stopped stopped stopped foreign unspecified unspecified unspecified unspecified unspecified  	I_ORG	null
14 by by by foreign unspecified unspecified unspecified unspecified unspecified  	I_ORG	null
15 to to to foreign unspecified unspecified unspecified unspecified unspecified  	I_ORG	null
16 say say say foreign unspecified unspecified unspecified unspecified unspecified  	I_ORG	null
17 hello hello hello foreign unspecified unspecified unspecified unspecified unspecified  	I_ORG	null
18 to to to foreign unspecified unspecified unspecified unspecified unspecified  	I_ORG	null
19 me me me foreign unspecified unspecified unspecified unspecified unspecified  	I_ORG	null
20 Remember Remember Remember foreign unspecified unspecified unspecified unspecified unspecified  	I_ORG	null
21 , , , punctuation unspecified unspecified unspecified unspecified unspecified  	O	null
22 ah ah ah foreign unspecified unspecified unspecified unspecified unspecified  	O	null
23 , , , punctuation unspecified unspecified unspecified unspecified unspecified  	O	null
24 that's that's that's foreign unspecified unspecified unspecified unspecified unspecified  	I_ORG	null
25 the the the foreign unspecified unspecified unspecified unspecified unspecified  	I_ORG	null
26 way way way foreign unspecified unspecified unspecified unspecified unspecified  	I_ORG	null
27 it it it foreign unspecified unspecified unspecified unspecified unspecified  	I_ORG	null
28 used used used foreign unspecified unspecified unspecified unspecified unspecified  	I_ORG	null
29 to to to foreign unspecified unspecified unspecified unspecified unspecified  	I_ORG	null
30 be be be foreign unspecified unspecified unspecified unspecified unspecified  	I_ORG	null
31 … … … punctuation unspecified unspecified unspecified unspecified unspecified  	O	null
32 It It It foreign unspecified unspecified unspecified unspecified unspecified  	I_ORG	null
33 seems seems seems foreign unspecified unspecified unspecified unspecified unspecified  	I_ORG	null
34 like like like foreign unspecified unspecified unspecified unspecified unspecified  	I_ORG	null
35 a a a foreign unspecified unspecified unspecified unspecified unspecified  	I_ORG	null
36 mighty mighty mighty foreign unspecified unspecified unspecified unspecified unspecified  	I_ORG	null
37 long long long foreign unspecified unspecified unspecified unspecified unspecified  	I_ORG	null
38 time time time foreign unspecified unspecified unspecified unspecified unspecified  	I_ORG	null
39 , , , punctuation unspecified unspecified unspecified unspecified unspecified  	O	null
40 Shoo Shoo Shoo foreign unspecified unspecified unspecified unspecified unspecified  	O	null
41 - - - punctuation unspecified unspecified unspecified unspecified unspecified  	O	null
42 bop bop bop foreign unspecified unspecified unspecified unspecified unspecified  	O	null
43 , , , punctuation unspecified unspecified unspecified unspecified unspecified  	O	null
44 shoo shoo shoo foreign unspecified unspecified unspecified unspecified unspecified  	O	null
45 - - - punctuation unspecified unspecified unspecified unspecified unspecified  	O	null
46 bop bop bop foreign unspecified unspecified unspecified unspecified unspecified  	O	null
47 , , , punctuation unspecified unspecified unspecified unspecified unspecified  	O	null
48 my my my foreign unspecified unspecified unspecified unspecified unspecified  	I_ORG	null
49 baby baby baby foreign unspecified unspecified unspecified unspecified unspecified  	I_ORG	null
50 It It It foreign unspecified unspecified unspecified unspecified unspecified  	I_ORG	null
51 seems seems seems foreign unspecified unspecified unspecified unspecified unspecified  	I_ORG	null
52 like like like foreign unspecified unspecified unspecified unspecified unspecified  	I_ORG	null
53 a a a foreign unspecified unspecified unspecified unspecified unspecified  	I_ORG	null
54 mighty mighty mighty foreign unspecified unspecified unspecified unspecified unspecified  	I_ORG	null
55 long long long foreign unspecified unspecified unspecified unspecified unspecified  	I_ORG	null
56 time time time foreign unspecified unspecified unspecified unspecified unspecified  	I_ORG	null
57 . . . punctuation unspecified unspecified unspecified unspecified unspecified  	O	null

0 Shoo Shoo Shoo foreign unspecified unspecified unspecified unspecified unspecified  	O	null
1 - - - punctuation unspecified unspecified unspecified unspecified unspecified  	O	null
2 bop bop bop foreign unspecified unspecified unspecified unspecified unspecified  	O	null
3 , , , punctuation unspecified unspecified unspecified unspecified unspecified  	O	null
4 shoo-bop shoo-bop shoo-bop foreign unspecified unspecified unspecified unspecified unspecified  	O	null
5 my my my foreign unspecified unspecified unspecified unspecified unspecified  	O	null
6 baby baby baby foreign unspecified unspecified unspecified unspecified unspecified  	O	null
7 , , , punctuation unspecified unspecified unspecified unspecified unspecified  	O	null
8 Shoo Shoo Shoo foreign unspecified unspecified unspecified unspecified unspecified  	O	null
9 - - - punctuation unspecified unspecified unspecified unspecified unspecified  	O	null
10 bop bop bop foreign unspecified unspecified unspecified unspecified unspecified  	O	null
11 , , , punctuation unspecified unspecified unspecified unspecified unspecified  	O	null
12 shoo shoo shoo foreign unspecified unspecified unspecified unspecified unspecified  	O	null
13 - - - punctuation unspecified unspecified unspecified unspecified unspecified  	O	null
14 bop bop bop foreign unspecified unspecified unspecified unspecified unspecified  	O	null
15 … … … punctuation unspecified unspecified unspecified unspecified unspecified  	O	null
16 Ohh Ohh Ohh foreign unspecified unspecified unspecified unspecified unspecified  	O	null
17 , , , punctuation unspecified unspecified unspecified unspecified unspecified  	O	null
18 yes yes yes foreign unspecified unspecified unspecified unspecified unspecified  	O	null
19 I I I foreign unspecified unspecified unspecified unspecified unspecified  	O	null
20 ' ' ' punctuation unspecified unspecified unspecified unspecified unspecified  	O	null
21 m m m foreign unspecified unspecified unspecified unspecified unspecified  	O	null
22 so so so foreign unspecified unspecified unspecified unspecified unspecified  	O	null
23 glad glad glad foreign unspecified unspecified unspecified unspecified unspecified  	O	null
24 , , , punctuation unspecified unspecified unspecified unspecified unspecified  	O	null
25 you're you're you're foreign unspecified unspecified unspecified unspecified unspecified  	O	null
26 here here here foreign unspecified unspecified unspecified unspecified unspecified  	O	null
27 again again again foreign unspecified unspecified unspecified unspecified unspecified  	O	null
28 … … … punctuation unspecified unspecified unspecified unspecified unspecified  	O	null
29 If If If foreign unspecified unspecified unspecified unspecified unspecified  	I_ORG	null
30 you're you're you're foreign unspecified unspecified unspecified unspecified unspecified  	I_ORG	null
31 not not not foreign unspecified unspecified unspecified unspecified unspecified  	I_ORG	null
32 gonna gonna gonna foreign unspecified unspecified unspecified unspecified unspecified  	I_ORG	null
33 stay stay stay foreign unspecified unspecified unspecified unspecified unspecified  	I_ORG	null
34 - - - punctuation unspecified unspecified unspecified unspecified unspecified  	O	null
35 Please Please Please foreign unspecified unspecified unspecified unspecified unspecified  	O	null
36 , , , punctuation unspecified unspecified unspecified unspecified unspecified  	O	null
37 don't don't don't foreign unspecified unspecified unspecified unspecified unspecified  	I_ORG	null
38 tease tease tease foreign unspecified unspecified unspecified unspecified unspecified  	I_ORG	null
39 me me me foreign unspecified unspecified unspecified unspecified unspecified  	I_ORG	null
40 like like like foreign unspecified unspecified unspecified unspecified unspecified  	I_ORG	null
41 you you you foreign unspecified unspecified unspecified unspecified unspecified  	I_ORG	null
42 did did did foreign unspecified unspecified unspecified unspecified unspecified  	I_ORG	null
43 before before before foreign unspecified unspecified unspecified unspecified unspecified  	I_ORG	null
44 … … … punctuation unspecified unspecified unspecified unspecified unspecified  	O	null
45 Because Because Because foreign unspecified unspecified unspecified unspecified unspecified  	I_ORG	null
46 I I I foreign unspecified unspecified unspecified unspecified unspecified  	I_ORG	null
47 still still still foreign unspecified unspecified unspecified unspecified unspecified  	I_ORG	null
48 love love love foreign unspecified unspecified unspecified unspecified unspecified  	I_ORG	null
49 you you you foreign unspecified unspecified unspecified unspecified unspecified  	I_ORG	null
50 so so so foreign unspecified unspecified unspecified unspecified unspecified  	I_ORG	null
51 although although although foreign unspecified unspecified unspecified unspecified unspecified  	I_ORG	null
52 , , , punctuation unspecified unspecified unspecified unspecified unspecified  	O	null
53 It It It foreign unspecified unspecified unspecified unspecified unspecified  	I_ORG	null
54 seems seems seems foreign unspecified unspecified unspecified unspecified unspecified  	I_ORG	null
55 like like like foreign unspecified unspecified unspecified unspecified unspecified  	I_ORG	null
56 a a a foreign unspecified unspecified unspecified unspecified unspecified  	I_ORG	null
57 mighty mighty mighty foreign unspecified unspecified unspecified unspecified unspecified  	I_ORG	null
58 long long long foreign unspecified unspecified unspecified unspecified unspecified  	I_ORG	null
59 time time time foreign unspecified unspecified unspecified unspecified unspecified  	I_ORG	null
60 , , , punctuation unspecified unspecified unspecified unspecified unspecified  	O	null
61 Shoo Shoo Shoo foreign unspecified unspecified unspecified unspecified unspecified  	O	null
62 - - - punctuation unspecified unspecified unspecified unspecified unspecified  	O	null
63 bop bop bop foreign unspecified unspecified unspecified unspecified unspecified  	O	null
64 , , , punctuation unspecified unspecified unspecified unspecified unspecified  	O	null
65 shoo shoo shoo foreign unspecified unspecified unspecified unspecified unspecified  	O	null
66 - - - punctuation unspecified unspecified unspecified unspecified unspecified  	O	null
67 bop bop bop foreign unspecified unspecified unspecified unspecified unspecified  	O	null
68 , , , punctuation unspecified unspecified unspecified unspecified unspecified  	O	null
69 my my my foreign unspecified unspecified unspecified unspecified unspecified  	I_ORG	null
70 baby baby baby foreign unspecified unspecified unspecified unspecified unspecified  	I_ORG	null
71 It It It foreign unspecified unspecified unspecified unspecified unspecified  	I_ORG	null
72 seems seems seems foreign unspecified unspecified unspecified unspecified unspecified  	I_ORG	null
73 like like like foreign unspecified unspecified unspecified unspecified unspecified  	I_ORG	null
74 a a a foreign unspecified unspecified unspecified unspecified unspecified  	I_ORG	null
75 mighty mighty mighty foreign unspecified unspecified unspecified unspecified unspecified  	I_ORG	null
76 long long long foreign unspecified unspecified unspecified unspecified unspecified  	I_ORG	null
77 time time time foreign unspecified unspecified unspecified unspecified unspecified  	I_ORG	null
78 . . . punctuation unspecified unspecified unspecified unspecified unspecified  	O	null

0 Ohh Ohh Ohh foreign unspecified unspecified unspecified unspecified unspecified  	O	null
1 , , , punctuation unspecified unspecified unspecified unspecified unspecified  	O	null
2 ohh ohh ohh foreign unspecified unspecified unspecified unspecified unspecified  	O	null
3 my my my foreign unspecified unspecified unspecified unspecified unspecified  	O	null
4 , , , punctuation unspecified unspecified unspecified unspecified unspecified  	O	null
5 my my my foreign unspecified unspecified unspecified unspecified unspecified  	O	null
6 my my my foreign unspecified unspecified unspecified unspecified unspecified  	O	null
7 my my my foreign unspecified unspecified unspecified unspecified unspecified  	O	null
8 I I I foreign unspecified unspecified unspecified unspecified unspecified  	O	null
9 ' ' ' punctuation unspecified unspecified unspecified unspecified unspecified  	O	null
10 m m m foreign unspecified unspecified unspecified unspecified unspecified  	I_ORG	null
11 so so so foreign unspecified unspecified unspecified unspecified unspecified  	I_ORG	null
12 happy happy happy foreign unspecified unspecified unspecified unspecified unspecified  	I_ORG	null
13 That That That foreign unspecified unspecified unspecified unspecified unspecified  	I_ORG	null
14 you're you're you're foreign unspecified unspecified unspecified unspecified unspecified  	I_ORG	null
15 here here here foreign unspecified unspecified unspecified unspecified unspecified  	I_ORG	null
16 … … … punctuation unspecified unspecified unspecified unspecified unspecified  	O	null
17 .. .. .. punctuation unspecified unspecified unspecified unspecified unspecified  	O	null

