0 נועה נועה נועה properName unspecified unspecified unspecified unspecified unspecified  	I_PERS	null
1 נולדה נולד נולדה verb feminine singular unspecified 3 past  	O	null
2 ב ב בשדה preposition unspecified unspecified unspecified unspecified unspecified 0 
2 שדה שדה בשדה properName unspecified unspecified unspecified unspecified unspecified  	O	null
3 בין בין בין preposition unspecified unspecified unspecified unspecified unspecified  	O	null
4 דשא דשא דשא noun masculine singular absolute unspecified unspecified  	O	null
5 ל ל לאבן preposition unspecified unspecified unspecified unspecified unspecified 0 
5 אבן אבן לאבן properName unspecified unspecified unspecified unspecified unspecified  	I_PERS	null
6 נועה נועה נועה properName unspecified unspecified unspecified unspecified unspecified  	I_PERS	null
7 היתה הוא היתה copula feminine singular unspecified 3 past  	O	null
8 כמו כמו כמו preposition unspecified unspecified unspecified unspecified unspecified  	O	null
9 אגל אגל אגל noun masculine singular absolute unspecified unspecified  	O	null
10 של של של shel-preposition unspecified unspecified unspecified unspecified unspecified  	O	null
11 טל טל טל properName unspecified unspecified unspecified unspecified unspecified  	I_PERS	null
12 חרצית חרצית חרצית noun feminine singular absolute unspecified unspecified  	O	null
13 היא הוא היא pronoun feminine singular unspecified 3 unspecified  	O	null
14 קטפה קטף קטפה verb feminine singular unspecified 3 past  	O	null
15 ב ב בשדה preposition unspecified unspecified unspecified unspecified unspecified 0 
15 ה ה בשדה definiteArticle unspecified unspecified unspecified unspecified unspecified 0 
15 השדה שדה בשדה noun masculine singular absolute unspecified unspecified  	O	null
16 ו ו ומן conjunction unspecified unspecified unspecified unspecified unspecified 0 
16 מן מן ומן preposition unspecified unspecified unspecified unspecified unspecified  	O	null
17 ה ה הכותרת definiteArticle unspecified unspecified unspecified unspecified unspecified 0 
17 הכותרת כותרת הכותרת noun feminine singular absolute unspecified unspecified  	O	null
18 תלשה תלש תלשה verb feminine singular unspecified 3 past  	O	null
19 עלעל עלעל עלעל verb masculine singular unspecified 3 past  	O	null
20 עלעל עלעל עלעל noun masculine singular absolute unspecified unspecified  	O	null

0 כן כן כן conjunction unspecified unspecified unspecified unspecified unspecified  	O	null
1 או או או conjunction unspecified unspecified unspecified unspecified unspecified  	O	null
2 לא לא לא negation unspecified unspecified unspecified unspecified unspecified  	O	null
3 , , , punctuation unspecified unspecified unspecified unspecified unspecified  	O	null
4 כן כן כן conjunction unspecified unspecified unspecified unspecified unspecified  	O	null
5 או או או conjunction unspecified unspecified unspecified unspecified unspecified  	O	null
6 לא לא לא negation unspecified unspecified unspecified unspecified unspecified  	O	null
7 , , , punctuation unspecified unspecified unspecified unspecified unspecified  	O	null
8 אלף ORD-CARD1000 אלף numeral masculine plural absolute unspecified unspecified  	O	null
9 שירים שיר שירים noun masculine plural absolute unspecified unspecified  	O	null
10 ו ו ושיר conjunction unspecified unspecified unspecified unspecified unspecified 0 
10 שיר שיר ושיר properName unspecified unspecified unspecified unspecified unspecified  	I_PERS	null
11 נועה נועה נועה properName unspecified unspecified unspecified unspecified unspecified  	I_PERS	null
12 כן כן כן conjunction unspecified unspecified unspecified unspecified unspecified  	O	null
13 או או או conjunction unspecified unspecified unspecified unspecified unspecified  	O	null
14 לא לא לא negation unspecified unspecified unspecified unspecified unspecified  	O	null
15 עלעלי עלעל עלעלי noun masculine plural construct unspecified unspecified  	O	null
16 כן כן כן noun masculine singular absolute unspecified unspecified  	O	null
17 או או או conjunction unspecified unspecified unspecified unspecified unspecified  	O	null
18 לא לא לא negation unspecified unspecified unspecified unspecified unspecified  	O	null
19 או או או conjunction unspecified unspecified unspecified unspecified unspecified  	O	null
20 אולי אולי אולי adverb unspecified unspecified unspecified unspecified unspecified  	O	null

0 נועה נועה נועה properName unspecified unspecified unspecified unspecified unspecified  	I_PERS	null
1 הובילה הוביל הובילה verb feminine singular unspecified 3 past  	O	null
2 את את אותו at-preposition unspecified unspecified unspecified unspecified unspecified  
2 ו ו אותו pronomial masculine singular unspecified 3 unspecified 0 	O	null
3 בין בין בין preposition unspecified unspecified unspecified unspecified unspecified  	O	null
4 דשא דשא דשא noun masculine singular absolute unspecified unspecified  	O	null
5 ל ל לאבן preposition unspecified unspecified unspecified unspecified unspecified 0 
5 אבן אבן לאבן properName unspecified unspecified unspecified unspecified unspecified  	I_PERS	null
6 נועה נועה נועה properName unspecified unspecified unspecified unspecified unspecified  	I_PERS	null
7 נשקה נשק נשקה verb feminine singular unspecified 3 past  	O	null
8 לו לו לו conjunction unspecified unspecified unspecified unspecified unspecified  	O	null
9 עם עם עם preposition unspecified unspecified unspecified unspecified unspecified  	O	null
10 רדת רדת רדת noun masculine singular construct unspecified unspecified  	O	null
11 ה ה הטל definiteArticle unspecified unspecified unspecified unspecified unspecified 0 
11 הטל טל הטל noun masculine singular absolute unspecified unspecified  	O	null
12 ו ו והוא conjunction unspecified unspecified unspecified unspecified unspecified 0 
12 הוא הוא והוא pronoun masculine singular unspecified 3 unspecified  	O	null
13 ב ב בעיניה preposition unspecified unspecified unspecified unspecified unspecified 0 
13 עין עין בעיניה noun feminine plural absolute unspecified unspecified  
13 ה ה בעיניה possessive feminine singular unspecified 3 unspecified 0 	O	null
14 של של שלה shel-preposition unspecified unspecified unspecified unspecified unspecified  
14 ה ה שלה pronomial feminine singular unspecified 3 unspecified 0 	O	null
15 הציץ הציץ הציץ verb masculine singular unspecified 3 past  	O	null
16 חרש חרש חרש noun masculine singular absolute unspecified unspecified  	O	null
17 חרש חרש חרש noun masculine singular absolute unspecified unspecified  	O	null
18 ו ו ובלא conjunction unspecified unspecified unspecified unspecified unspecified 0 
18 ב ב ובלא preposition unspecified unspecified unspecified unspecified unspecified 0 
18 לא לא ובלא negation unspecified unspecified unspecified unspecified unspecified  	O	null
19 מילה מילה מילה noun feminine singular absolute unspecified unspecified  	O	null
20 שאל שאל שאל verb masculine singular unspecified 3 past  	O	null
21 : : : punctuation unspecified unspecified unspecified unspecified unspecified  	O	null

0 כן כן כן conjunction unspecified unspecified unspecified unspecified unspecified  	O	null
1 או או או conjunction unspecified unspecified unspecified unspecified unspecified  	O	null
2 לא... לא... לא... adjective masculine singular construct unspecified unspecified  	O	null

0 נועה נועה נועה properName unspecified unspecified unspecified unspecified unspecified  	I_PERS	null
1 הרחיקה הרחיק הרחיקה verb feminine singular unspecified 3 past  	O	null
2 נדוד נדד נדוד verb masculine singular unspecified 2 imperative  	O	null
3 מ מ מדשא preposition unspecified unspecified unspecified unspecified unspecified 0 
3 דשא דשא מדשא noun masculine singular absolute unspecified unspecified  	O	null
4 מ מ מאבן preposition unspecified unspecified unspecified unspecified unspecified 0 
4 אבן אבן מאבן noun feminine singular absolute unspecified unspecified  	O	null
5 מ מ מתלתליה preposition unspecified unspecified unspecified unspecified unspecified 0 
5 תלתלי תלתל מתלתליה noun masculine plural absolute unspecified unspecified  
5 ה ה מתלתליה possessive feminine singular unspecified 3 unspecified 0 	O	null
6 נמחה נמחה נמחה verb masculine singular unspecified 3 past  	O	null
7 לו לו לו conjunction unspecified unspecified unspecified unspecified unspecified  	O	null
8 ה ה הטל definiteArticle unspecified unspecified unspecified unspecified unspecified 0 
8 הטל טל הטל noun masculine singular absolute unspecified unspecified  	O	null
9 ו ו ומאה conjunction unspecified unspecified unspecified unspecified unspecified 0 
9 מאה ORD-CARD100 ומאה numeral feminine plural absolute unspecified unspecified  	O	null
10 חרציות חרצית חרציות noun feminine plural absolute unspecified unspecified  	O	null
11 ה ה השדה definiteArticle unspecified unspecified unspecified unspecified unspecified 0 
11 השדה שדה השדה noun masculine singular absolute unspecified unspecified  	O	null
12 צופות צפה צופות verb feminine plural unspecified any beinoni  	O	null
13 אחרי אחרי אחריה preposition unspecified unspecified unspecified unspecified unspecified  
13 ה ה אחריה pronomial feminine singular unspecified 3 unspecified 0 	O	null
14 ו ו וכל conjunction unspecified unspecified unspecified unspecified unspecified 0 
14 כל כול וכל quantifier unspecified unspecified construct unspecified unspecified  	O	null
15 עלה עלה עלה noun masculine singular absolute unspecified unspecified  	O	null
16 ישאל שאל ישאל verb masculine singular unspecified 3 future  	O	null
17 : : : punctuation unspecified unspecified unspecified unspecified unspecified  	O	null

0 כן כן כן conjunction unspecified unspecified unspecified unspecified unspecified  	O	null
1 או או או conjunction unspecified unspecified unspecified unspecified unspecified  	O	null
2 לא..... לא..... לא..... adjective masculine singular construct unspecified unspecified  	O	null

0 נועה נועה נועה properName unspecified unspecified unspecified unspecified unspecified  	I_PERS	null
1 היא הוא היא pronoun feminine singular unspecified 3 unspecified  	O	null
2 שם שם שם adverb unspecified unspecified unspecified unspecified unspecified  	O	null
3 ב ב בשדה preposition unspecified unspecified unspecified unspecified unspecified 0 
3 ה ה בשדה definiteArticle unspecified unspecified unspecified unspecified unspecified 0 
3 השדה שדה בשדה noun masculine singular absolute unspecified unspecified  	O	null
4 בין בין בין preposition unspecified unspecified unspecified unspecified unspecified  	O	null
5 דשא דשא דשא noun masculine singular absolute unspecified unspecified  	O	null
6 ל ל לאבן preposition unspecified unspecified unspecified unspecified unspecified 0 
6 אבן אבן לאבן noun feminine singular construct unspecified unspecified  	O	null
7 שיר שיר שיר noun masculine singular absolute unspecified unspecified  	O	null
8 אחרון אחרון אחרון adjective masculine singular absolute unspecified unspecified  	O	null
9 מ מ מזמר preposition unspecified unspecified unspecified unspecified unspecified 0 
9 זמר זמר מזמר noun masculine singular absolute unspecified unspecified  	O	null
10 ל ל לה preposition unspecified unspecified unspecified unspecified unspecified  
10 ה ה לה pronomial feminine singular unspecified 3 unspecified 0 	O	null
11 ה ה הטל definiteArticle unspecified unspecified unspecified unspecified unspecified 0 
11 הטל טל הטל noun masculine singular absolute unspecified unspecified  	O	null
12 ו ו וכל conjunction unspecified unspecified unspecified unspecified unspecified 0 
12 כל כול וכל quantifier unspecified unspecified construct unspecified unspecified  	O	null
13 חרציות חרצית חרציות noun feminine plural construct unspecified unspecified  	O	null
14 ה ה השדה definiteArticle unspecified unspecified unspecified unspecified unspecified 0 
14 השדה שדה השדה noun masculine singular absolute unspecified unspecified  	O	null
15 יפות יפה יפות adjective feminine plural absolute unspecified unspecified  	O	null
16 ה ה הכותרת definiteArticle unspecified unspecified unspecified unspecified unspecified 0 
16 הכותרת כותרת הכותרת noun feminine singular absolute unspecified unspecified  	O	null
17 בוכות בכה בוכות verb feminine plural unspecified any beinoni  	O	null
18 עלעל עלעל עלעל noun masculine singular absolute unspecified unspecified  	O	null
19 על על על preposition unspecified unspecified unspecified unspecified unspecified  	O	null
20 על על על preposition unspecified unspecified unspecified unspecified unspecified  	O	null

0 כן כן כן conjunction unspecified unspecified unspecified unspecified unspecified  	O	null
1 או או או conjunction unspecified unspecified unspecified unspecified unspecified  	O	null
2 לא לא לא negation unspecified unspecified unspecified unspecified unspecified  	O	null
3 , , , punctuation unspecified unspecified unspecified unspecified unspecified  	O	null
4 כן כן כן conjunction unspecified unspecified unspecified unspecified unspecified  	O	null
5 או או או conjunction unspecified unspecified unspecified unspecified unspecified  	O	null
6 לא לא לא negation unspecified unspecified unspecified unspecified unspecified  	O	null
7 אלף ORD-CARD1000 אלף numeral masculine plural absolute unspecified unspecified  	O	null
8 שירים שיר שירים noun masculine plural absolute unspecified unspecified  	O	null
9 ו ו ושיר conjunction unspecified unspecified unspecified unspecified unspecified 0 
9 שיר שיר ושיר properName unspecified unspecified unspecified unspecified unspecified  	I_PERS	null
10 נועה נועה נועה properName unspecified unspecified unspecified unspecified unspecified  	I_PERS	null
11 כן כן כן conjunction unspecified unspecified unspecified unspecified unspecified  	O	null
12 או או או conjunction unspecified unspecified unspecified unspecified unspecified  	O	null
13 לא לא לא negation unspecified unspecified unspecified unspecified unspecified  	O	null
14 אללי אללי אללי adverb unspecified unspecified unspecified unspecified unspecified  	O	null
15 , , , punctuation unspecified unspecified unspecified unspecified unspecified  	O	null
16 שבה שב שבה verb feminine singular unspecified 3 past  	O	null
17 נועה נועה נועה properName unspecified unspecified unspecified unspecified unspecified  	I_PERS	null
18 אל אל אלי preposition unspecified unspecified unspecified unspecified unspecified  
18 י י אלי pronomial masculine-and-feminine singular unspecified 1 unspecified 0 	O	null

