0 פמוטות פמוטות פמוטות noun masculine singular absolute unspecified unspecified  	O	null
1 של של של shel-preposition unspecified unspecified unspecified unspecified unspecified  	O	null
2 זהב זהב זהב noun masculine singular absolute unspecified unspecified  	O	null
3 , , , punctuation unspecified unspecified unspecified unspecified unspecified  	O	null
4 מחלפות מחלפה מחלפות noun feminine plural absolute unspecified unspecified  	O	null
5 של של של shel-preposition unspecified unspecified unspecified unspecified unspecified  	O	null
6 כסף כסף כסף noun masculine singular absolute unspecified unspecified  	O	null
7 , , , punctuation unspecified unspecified unspecified unspecified unspecified  	O	null
8 ערב ערב ערב noun masculine singular absolute unspecified unspecified  	O	null
9 כבר כבר כבר adverb unspecified unspecified unspecified unspecified unspecified  	O	null
10 עזב עזב עזב verb masculine singular unspecified 3 past  	O	null
11 , , , punctuation unspecified unspecified unspecified unspecified unspecified  	O	null
12 יום יום יום noun masculine singular absolute unspecified unspecified  	O	null
13 על על עליה preposition unspecified unspecified unspecified unspecified unspecified  
13 ה ה עליה pronomial feminine singular unspecified 3 unspecified 0 	O	null
14 רד ירד רד verb masculine singular unspecified 2 imperative  	O	null
15 , , , punctuation unspecified unspecified unspecified unspecified unspecified  	O	null

0 סבת סבה סבתי noun feminine singular absolute unspecified unspecified  
0 י י סבתי possessive masculine-and-feminine singular unspecified 1 unspecified 0 	O	null
1 יפתה פיתה יפתה verb masculine singular unspecified 3 future  	O	null
2 מאוד מאוד מאוד adverb unspecified unspecified unspecified unspecified unspecified  	O	null
3 ב ב באמונה preposition unspecified unspecified unspecified unspecified unspecified 0 
3 אמונה אמונה באמונה properName unspecified unspecified unspecified unspecified unspecified  	I_PERS	null
4 ו ו וחסד conjunction unspecified unspecified unspecified unspecified unspecified 0 
4 חסד חסד וחסד noun masculine singular absolute unspecified unspecified  	O	null
5 , , , punctuation unspecified unspecified unspecified unspecified unspecified  	O	null
6 סבת סבה סבתי noun feminine singular absolute unspecified unspecified  
6 י י סבתי possessive masculine-and-feminine singular unspecified 1 unspecified 0 	O	null
7 מן מן מן preposition unspecified unspecified unspecified unspecified unspecified  	O	null
8 ה ה הישוב definiteArticle unspecified unspecified unspecified unspecified unspecified 0 
8 הישוב יישוב הישוב noun masculine singular absolute unspecified unspecified  	O	null
9 ש ש שבמרחק relativizer/subordinatingConjunction unspecified unspecified unspecified unspecified unspecified 0 
9 ב ב שבמרחק preposition unspecified unspecified unspecified unspecified unspecified 0 
9 ה ה שבמרחק definiteArticle unspecified unspecified unspecified unspecified unspecified 0 
9 המרחק מרחק שבמרחק noun masculine singular absolute unspecified unspecified  	O	null
10 אבד אבד אבד verb masculine singular unspecified 3 past  	O	null
11 . . . punctuation unspecified unspecified unspecified unspecified unspecified  	O	null

0 אם אם אם conjunction unspecified unspecified unspecified unspecified unspecified  	O	null
1 תביט הביט תביט verb feminine singular unspecified 3 future  	O	null
2 אל אל אל preposition unspecified unspecified unspecified unspecified unspecified  	O	null
3 תוך תוך תוך noun masculine singular construct unspecified unspecified  	O	null
4 ה ה הערב definiteArticle unspecified unspecified unspecified unspecified unspecified 0 
4 הערב ערב הערב noun masculine singular absolute unspecified unspecified  	O	null
5 אל אל אל preposition unspecified unspecified unspecified unspecified unspecified  	O	null
6 חלון חילון חלון noun masculine singular construct unspecified unspecified  	O	null
7 בית בית בית noun masculine singular construct unspecified unspecified  	O	null
8 סבת סבה סבתי noun feminine singular absolute unspecified unspecified  
8 י י סבתי possessive masculine-and-feminine singular unspecified 1 unspecified 0 	O	null
9 , , , punctuation unspecified unspecified unspecified unspecified unspecified  	O	null
10 אור אור אור noun masculine singular construct unspecified unspecified  	O	null
11 שבת שבת שבת properName unspecified unspecified unspecified unspecified unspecified  	I_PERS	null
12 , , , punctuation unspecified unspecified unspecified unspecified unspecified  	O	null
13 ל ל לבן preposition unspecified unspecified unspecified unspecified unspecified 0 
13 בן בן לבן properName unspecified unspecified unspecified unspecified unspecified  	I_PERS	null
14 אדרת אדרת אדרת properName unspecified unspecified unspecified unspecified unspecified  	I_PERS	null
15 , , , punctuation unspecified unspecified unspecified unspecified unspecified  	O	null
16 מ מ מביתה preposition unspecified unspecified unspecified unspecified unspecified 0 
16 בית בית מביתה noun masculine singular absolute unspecified unspecified  
16 ה ה מביתה possessive feminine singular unspecified 3 unspecified 0 	O	null
17 - - - punctuation unspecified unspecified unspecified unspecified unspecified  	O	null
18 נושק נושק נושק verb masculine singular unspecified 3 past  	O	null
19 את את אותי at-preposition unspecified unspecified unspecified unspecified unspecified  
19 י י אותי pronomial masculine-and-feminine singular unspecified 1 unspecified 0 	O	null
20 . . . punctuation unspecified unspecified unspecified unspecified unspecified  	O	null

0 ארבעה CARD4 ארבעה numeral masculine plural absolute unspecified unspecified  	O	null
1 דורות דור דורות noun masculine plural absolute unspecified unspecified  	O	null
2 על על על preposition unspecified unspecified unspecified unspecified unspecified  	O	null
3 חריש חריש חריש noun masculine singular absolute unspecified unspecified  	O	null
4 פניה פנייה פניה noun feminine singular absolute unspecified unspecified  	O	null
5 , , , punctuation unspecified unspecified unspecified unspecified unspecified  	O	null
6 עוד עוד עוד adverb unspecified unspecified unspecified unspecified unspecified  	O	null
7 הולכים הלך הולכים verb masculine plural unspecified any beinoni  	O	null
8 אורות אור אורות noun masculine plural absolute unspecified unspecified  	O	null
9 ב ב ביופיה preposition unspecified unspecified unspecified unspecified unspecified 0 
9 יופי יופי ביופיה noun masculine singular absolute unspecified unspecified  
9 ה ה ביופיה possessive feminine singular unspecified 3 unspecified 0 	O	null
10 ה ה הרך definiteArticle unspecified unspecified unspecified unspecified unspecified 0 
10 הרך רך הרך adjective masculine singular absolute unspecified unspecified  	O	null
11 , , , punctuation unspecified unspecified unspecified unspecified unspecified  	O	null

0 סבת סבה סבתי noun feminine singular absolute unspecified unspecified  
0 י י סבתי possessive masculine-and-feminine singular unspecified 1 unspecified 0 	O	null
1 היא הוא היא pronoun feminine singular unspecified 3 unspecified  	O	null
2 פרח פרח פרח properName unspecified unspecified unspecified unspecified unspecified  	I_PERS	null
3 בר בר בר properName unspecified unspecified unspecified unspecified unspecified  	I_PERS	null
4 היא הוא היא pronoun feminine singular unspecified 3 unspecified  	O	null
5 ארץ ארץ ארץ noun feminine singular absolute unspecified unspecified  	O	null
6 ו ו ובניה conjunction unspecified unspecified unspecified unspecified unspecified 0 
6 בניה בנייה ובניה properName unspecified unspecified unspecified unspecified unspecified  	I_PERS	null
7 , , , punctuation unspecified unspecified unspecified unspecified unspecified  	O	null
8 היא הוא היא pronoun feminine singular unspecified 3 unspecified  	O	null
9 ה ה המים definiteArticle unspecified unspecified unspecified unspecified unspecified 0 
9 המים מים המים noun masculine plural absolute unspecified unspecified  	O	null
10 ו ו והפת conjunction unspecified unspecified unspecified unspecified unspecified 0 
10 ה ה והפת definiteArticle unspecified unspecified unspecified unspecified unspecified 0 
10 הפת פת והפת properName unspecified unspecified unspecified unspecified unspecified  	I_PERS	null
11 אשר אשר אשר properName masculine singular unspecified unspecified unspecified  	I_PERS	null
12 אוהב אהב אוהב verb masculine singular unspecified any beinoni  	O	null
13 כל כול כל quantifier unspecified unspecified construct unspecified unspecified  	O	null
14 כך כך כך pronoun unspecified unspecified unspecified unspecified unspecified  	O	null
15 . . . punctuation unspecified unspecified unspecified unspecified unspecified  	O	null

0 אם אם אם conjunction unspecified unspecified unspecified unspecified unspecified  	O	null
1 תביט הביט תביט verb feminine singular unspecified 3 future  	O	null
2 אל אל אל preposition unspecified unspecified unspecified unspecified unspecified  	O	null
3 תוך תוך תוך noun masculine singular construct unspecified unspecified  	O	null
4 ה ה הערב... definiteArticle unspecified unspecified unspecified unspecified unspecified 0 
4 הערב... הערב... הערב... noun feminine plural absolute unspecified unspecified  	O	null

0 ב ב במישעול preposition unspecified unspecified unspecified unspecified unspecified 0 
0 מישעו מישעו במישעול noun masculine-and-feminine plural absolute unspecified unspecified  
0 י י במישעול possessive masculine-and-feminine singular unspecified 1 unspecified 0 	O	null
1 חיוור חיוור חיוור adjective masculine singular absolute unspecified unspecified  	O	null
2 ב ב במישעול preposition unspecified unspecified unspecified unspecified unspecified 0 
2 מישעו מישעו במישעול noun masculine-and-feminine plural absolute unspecified unspecified  
2 י י במישעול possessive masculine-and-feminine singular unspecified 1 unspecified 0 	O	null
3 ש ש שכוח relativizer/subordinatingConjunction unspecified unspecified unspecified unspecified unspecified 0 
3 כוח כוח שכוח noun masculine singular absolute unspecified unspecified  	O	null
4 , , , punctuation unspecified unspecified unspecified unspecified unspecified  	O	null
5 בית בית בית noun masculine singular absolute unspecified unspecified  	O	null
6 ו ו וגדר conjunction unspecified unspecified unspecified unspecified unspecified 0 
6 גדר גדר וגדר noun feminine singular absolute unspecified unspecified  	O	null
7 ו ו ובברוש conjunction unspecified unspecified unspecified unspecified unspecified 0 
7 ב ב ובברוש preposition unspecified unspecified unspecified unspecified unspecified 0 
7 ברוש ברוש ובברוש properName unspecified unspecified unspecified unspecified unspecified  	I_PERS	null
8 איוושה איוושה איוושה properName unspecified unspecified unspecified unspecified unspecified  	I_PERS	null
9 , , , punctuation unspecified unspecified unspecified unspecified unspecified  	O	null

0 סבת סבה סבתי noun feminine singular absolute unspecified unspecified  
0 י י סבתי possessive masculine-and-feminine singular unspecified 1 unspecified 0 	O	null
1 על על על preposition unspecified unspecified unspecified unspecified unspecified  	O	null
2 יד יד יד noun feminine singular absolute unspecified unspecified  	O	null
3 , , , punctuation unspecified unspecified unspecified unspecified unspecified  	O	null
4 על על על preposition unspecified unspecified unspecified unspecified unspecified  	O	null
5 יד יד יד noun feminine singular absolute unspecified unspecified  	O	null
6 , , , punctuation unspecified unspecified unspecified unspecified unspecified  	O	null
7 עם עם עם preposition unspecified unspecified unspecified unspecified unspecified  	O	null
8 זמר זמר זמר noun masculine singular construct unspecified unspecified  	O	null
9 ה ה המפוח definiteArticle unspecified unspecified unspecified unspecified unspecified 0 
9 המפוח מפוח המפוח noun masculine singular absolute unspecified unspecified  	O	null
10 , , , punctuation unspecified unspecified unspecified unspecified unspecified  	O	null
11 מהלכת הילך מהלכת verb feminine singular unspecified any beinoni  	O	null
12 ל ל לאיטה preposition unspecified unspecified unspecified unspecified unspecified 0 
12 איטה איטה לאיטה properName unspecified unspecified unspecified unspecified unspecified  	I_PERS	null
13 על על על preposition unspecified unspecified unspecified unspecified unspecified  	O	null
14 ארץ ארץ ארץ noun feminine singular absolute unspecified unspecified  	O	null
15 חדשה חדש חדשה adjective feminine singular absolute unspecified unspecified  	O	null
16 . . . punctuation unspecified unspecified unspecified unspecified unspecified  	O	null

0 אם אם אם conjunction unspecified unspecified unspecified unspecified unspecified  	O	null
1 תביט הביט תביט verb feminine singular unspecified 3 future  	O	null
2 אל אל אל preposition unspecified unspecified unspecified unspecified unspecified  	O	null
3 תוך תוך תוך noun masculine singular construct unspecified unspecified  	O	null
4 ה ה הערב... definiteArticle unspecified unspecified unspecified unspecified unspecified 0 
4 הערב... הערב... הערב... noun feminine plural absolute unspecified unspecified  	O	null

