0 לפעמים לפעמים לפעמים adverb unspecified unspecified unspecified unspecified unspecified  	O	null
1 אני הוא אני pronoun masculine-and-feminine singular unspecified 1 unspecified  	O	null
2 מאבד איבד מאבד verb masculine singular unspecified any beinoni  	O	null
3 גישה גישה גישה noun feminine singular absolute unspecified unspecified  	O	null
4 ל ל לאנשים preposition unspecified unspecified unspecified unspecified unspecified 0 
4 ה ה לאנשים definiteArticle unspecified unspecified unspecified unspecified unspecified 0 
4 האנשים איש לאנשים noun masculine plural absolute unspecified unspecified  	O	null
5 מסוימים סוים מסוימים verb masculine plural unspecified any beinoni  	O	null
6 לפעמים לפעמים לפעמים adverb unspecified unspecified unspecified unspecified unspecified  	O	null
7 אני הוא אני pronoun masculine-and-feminine singular unspecified 1 unspecified  	O	null
8 מגלה גילה מגלה participle masculine singular construct any unspecified  	O	null
9 חולשה חולשה חולשה noun feminine singular absolute unspecified unspecified  	O	null
10 ל ל למוכשרים preposition unspecified unspecified unspecified unspecified unspecified 0 
10 ה ה למוכשרים definiteArticle unspecified unspecified unspecified unspecified unspecified 0 
10 המוכשרים הוכשר למוכשרים participle masculine plural absolute any unspecified  	O	null
11 מ מ מיומנים preposition unspecified unspecified unspecified unspecified unspecified 0 
11 יומנים יומן מיומנים noun masculine plural absolute unspecified unspecified  	O	null
12 מאבד איבד מאבד verb masculine singular unspecified any beinoni  	O	null
13 גישה גישה גישה noun feminine singular absolute unspecified unspecified  	O	null
14 מגלה גילה מגלה participle masculine singular construct any unspecified  	O	null
15 חולשה חולשה חולשה noun feminine singular absolute unspecified unspecified  	O	null
16 ו ו ומוצא conjunction unspecified unspecified unspecified unspecified unspecified 0 
16 מוצא מוצא ומוצא properName masculine singular unspecified unspecified unspecified  	I_LOC	null
17 רק רק רק conjunction unspecified unspecified unspecified unspecified unspecified  	O	null
18 את את את at-preposition unspecified unspecified unspecified unspecified unspecified  	O	null
19 עצמי עצם עצמי verb feminine singular unspecified 2 imperative  	O	null
20 לפעמים לפעמים לפעמים adverb unspecified unspecified unspecified unspecified unspecified  	O	null
21 אני הוא אני pronoun masculine-and-feminine singular unspecified 1 unspecified  	O	null
22 מחפש חיפש מחפש verb masculine singular unspecified any beinoni  	O	null
23 סיבה סיבה סיבה noun feminine singular absolute unspecified unspecified  	O	null
24 ל ל לשינויים preposition unspecified unspecified unspecified unspecified unspecified 0 
24 ה ה לשינויים definiteArticle unspecified unspecified unspecified unspecified unspecified 0 
24 השינויים שינוי לשינויים noun masculine plural absolute unspecified unspecified  	O	null
25 מיותרים מיותר מיותרים adjective masculine plural absolute unspecified unspecified  	O	null
26 לפעמים לפעמים לפעמים adverb unspecified unspecified unspecified unspecified unspecified  	O	null
27 אני הוא אני pronoun masculine-and-feminine singular unspecified 1 unspecified  	O	null
28 מבקש ביקש מבקש verb masculine singular unspecified any beinoni  	O	null
29 פינה פינה פינה noun feminine singular absolute unspecified unspecified  	O	null
30 להתייחד התייחד להתייחד verb unspecified unspecified unspecified unspecified infinitive  	O	null
31 קצת קצת קצת quantifier unspecified unspecified construct unspecified unspecified  	O	null
32 עם עם עם preposition unspecified unspecified unspecified unspecified unspecified  	O	null
33 עצמי עצם עצמי verb feminine singular unspecified 2 imperative  	O	null
34 מחפש חיפש מחפש verb masculine singular unspecified any beinoni  	O	null
35 סיבה סיבה סיבה noun feminine singular absolute unspecified unspecified  	O	null
36 מבקש ביקש מבקש verb masculine singular unspecified any beinoni  	O	null
37 פינה פינה פינה noun feminine singular absolute unspecified unspecified  	O	null
38 ו ו ונותר conjunction unspecified unspecified unspecified unspecified unspecified 0 
38 נותר נותר ונותר verb masculine singular unspecified 3 past  	O	null
39 ל ל לי preposition unspecified unspecified unspecified unspecified unspecified  
39 י י לי pronomial masculine-and-feminine singular unspecified 1 unspecified 0 	O	null
40 ל ל לבדי preposition unspecified unspecified unspecified unspecified unspecified 0 
40 בדי בד לבדי noun masculine plural construct unspecified unspecified  	O	null
41 עלה עלה עלה verb masculine singular unspecified 2 imperative  	O	null
42 ימי יום ימי noun masculine plural construct unspecified unspecified  	O	null
43 עלה עלה עלה verb masculine singular unspecified 2 imperative  	O	null
44 לילי ליל לילי properName unspecified unspecified unspecified unspecified unspecified  	I_PERS	null
45 עלה עלה עלה verb masculine singular unspecified 2 imperative  	O	null
46 מ מ מהזרה preposition unspecified unspecified unspecified unspecified unspecified 0 
46 ה ה מהזרה definiteArticle unspecified unspecified unspecified unspecified unspecified 0 
46 הזרה זר מהזרה adjective feminine singular absolute unspecified unspecified  	O	null
47 ל ל לי preposition unspecified unspecified unspecified unspecified unspecified  
47 י י לי pronomial masculine-and-feminine singular unspecified 1 unspecified 0 	I_ORG	null
48 שחל שחל שחל properName unspecified unspecified unspecified unspecified unspecified  	I_ORG	null
49 נתהנה נתהנה נתהנה properName unspecified unspecified unspecified unspecified unspecified  	I_ORG	null
50 עלה עלה עלה verb masculine singular unspecified 2 imperative  	O	null
51 מזל מזל מזלי noun masculine singular absolute unspecified unspecified  
51 י י מזלי possessive masculine-and-feminine singular unspecified 1 unspecified 0 	O	null
52 עלה עלה עלה verb masculine singular unspecified 2 imperative  	I_LOC	null
53 אהבלי אהבלי אהבלי properName unspecified unspecified unspecified unspecified unspecified  	I_PERS	null
54 עלה עלה עלה verb masculine singular unspecified 2 imperative  	O	null
55 נייתי נייתי נייתי properName unspecified unspecified unspecified unspecified unspecified  	I_PERS	null
56 פדוניה פדוניה פדוניה properName unspecified unspecified unspecified unspecified unspecified  	I_PERS	null
57 לפעמים לפעמים לפעמים adverb unspecified unspecified unspecified unspecified unspecified  	O	null
58 אני הוא אני pronoun masculine-and-feminine singular unspecified 1 unspecified  	O	null
59 מ מ מרחם preposition unspecified unspecified unspecified unspecified unspecified 0 
59 רחם רחם מרחם noun masculine singular construct unspecified unspecified  	O	null
60 כך כך כך pronoun unspecified unspecified unspecified unspecified unspecified  	O	null
61 סתם סתם סתם adverb unspecified unspecified unspecified unspecified unspecified  	O	null
62 על על על preposition unspecified unspecified unspecified unspecified unspecified  	O	null
63 אנשים איש אנשים noun masculine plural absolute unspecified unspecified  	O	null
64 מאושרים אושר מאושרים verb masculine plural unspecified any beinoni  	O	null
65 לפעמים לפעמים לפעמים adverb unspecified unspecified unspecified unspecified unspecified  	O	null
66 אני הוא אני pronoun masculine-and-feminine singular unspecified 1 unspecified  	O	null
67 מתחרט התחרט מתחרט verb masculine singular unspecified any beinoni  	O	null
68 מ מ מידי preposition unspecified unspecified unspecified unspecified unspecified 0 
68 יד יד מידי noun feminine plural absolute unspecified unspecified  
68 י י מידי possessive masculine-and-feminine singular unspecified 1 unspecified 0 	O	null
69 על על על preposition unspecified unspecified unspecified unspecified unspecified  	O	null
70 מעשים מעשה מעשים noun masculine plural absolute unspecified unspecified  	O	null
71 הגיוניים הגיוני הגיוניים adjective masculine plural absolute unspecified unspecified  	O	null
72 מ מ מרחם preposition unspecified unspecified unspecified unspecified unspecified 0 
72 רחם רחם מרחם noun masculine singular construct unspecified unspecified  	O	null
73 כך כך כך pronoun unspecified unspecified unspecified unspecified unspecified  	O	null
74 סתם סתם סתם adverb unspecified unspecified unspecified unspecified unspecified  	O	null
75 מתחרט התחרט מתחרט verb masculine singular unspecified any beinoni  	O	null
76 מ מ מידי preposition unspecified unspecified unspecified unspecified unspecified 0 
76 יד יד מידי noun feminine plural absolute unspecified unspecified  
76 י י מידי possessive masculine-and-feminine singular unspecified 1 unspecified 0 	O	null
77 ו ו ושואל conjunction unspecified unspecified unspecified unspecified unspecified 0 
77 שואל שאל ושואל participle masculine singular construct any unspecified  	O	null
78 אז אז אז conjunction unspecified unspecified unspecified unspecified unspecified  	O	null
79 את את את at-preposition unspecified unspecified unspecified unspecified unspecified  	O	null
80 עצמי עצם עצמי verb feminine singular unspecified 2 imperative  	I_ORG	null
81 עלה עלה עלה verb masculine singular unspecified 2 imperative  	O	null
82 יימי יימי יימי noun masculine plural construct unspecified unspecified  	O	null
83 עלה עלה עלה verb masculine singular unspecified 2 imperative  	I_LOC	null
84 ליילי ליילי ליילי properName unspecified unspecified unspecified unspecified unspecified  	I_PERS	null
85 עלה עלה עלה verb masculine singular unspecified 2 imperative  	O	null
86 מ מ מהזרה preposition unspecified unspecified unspecified unspecified unspecified 0 
86 ה ה מהזרה definiteArticle unspecified unspecified unspecified unspecified unspecified 0 
86 הזרה זר מהזרה adjective feminine singular absolute unspecified unspecified  	O	null
87 ל ל לי preposition unspecified unspecified unspecified unspecified unspecified  
87 י י לי pronomial masculine-and-feminine singular unspecified 1 unspecified 0 	I_ORG	null
88 שחל שחל שחל properName unspecified unspecified unspecified unspecified unspecified  	I_ORG	null
89 נתהנה נתהנה נתהנה properName unspecified unspecified unspecified unspecified unspecified  	I_ORG	null
90 עלה עלה עלה verb masculine singular unspecified 2 imperative  	O	null
91 מזל מזל מזלי noun masculine singular absolute unspecified unspecified  
91 י י מזלי possessive masculine-and-feminine singular unspecified 1 unspecified 0 	O	null
92 עלה עלה עלה verb masculine singular unspecified 2 imperative  	I_LOC	null
93 אהבלי אהבלי אהבלי properName unspecified unspecified unspecified unspecified unspecified  	I_PERS	null
94 עלה עלה עלה verb masculine singular unspecified 2 imperative  	O	null
95 נייתי נייתי נייתי properName unspecified unspecified unspecified unspecified unspecified  	I_PERS	null
96 פדוניה פדוניה פדוניה properName unspecified unspecified unspecified unspecified unspecified  	I_PERS	null
97 עלה עלה עלה verb masculine singular unspecified 2 imperative  	O	null
98 ימי יום ימי noun masculine plural construct unspecified unspecified  	O	null
99 עלה עלה עלה verb masculine singular unspecified 2 imperative  	O	null
100 לילי ליל לילי properName unspecified unspecified unspecified unspecified unspecified  	I_PERS	null
101 עלה עלה עלה verb masculine singular unspecified 2 imperative  	O	null
102 מ מ מהזרה preposition unspecified unspecified unspecified unspecified unspecified 0 
102 ה ה מהזרה definiteArticle unspecified unspecified unspecified unspecified unspecified 0 
102 הזרה זר מהזרה adjective feminine singular absolute unspecified unspecified  	O	null
103 ל ל לי preposition unspecified unspecified unspecified unspecified unspecified  
103 י י לי pronomial masculine-and-feminine singular unspecified 1 unspecified 0 	I_ORG	null
104 שחל שחל שחל properName unspecified unspecified unspecified unspecified unspecified  	I_ORG	null
105 נתהנה נתהנה נתהנה properName unspecified unspecified unspecified unspecified unspecified  	I_ORG	null
106 עלה עלה עלה verb masculine singular unspecified 2 imperative  	O	null
107 מזל מזל מזלי noun masculine singular absolute unspecified unspecified  
107 י י מזלי possessive masculine-and-feminine singular unspecified 1 unspecified 0 	O	null
108 עלה עלה עלה verb masculine singular unspecified 2 imperative  	I_LOC	null
109 אהבלי אהבלי אהבלי properName unspecified unspecified unspecified unspecified unspecified  	I_PERS	null
110 עלה עלה עלה verb masculine singular unspecified 2 imperative  	O	null
111 נייתי נייתי נייתי verb masculine-and-feminine singular unspecified 1 past  	O	null
112 עלה עלה עלה verb masculine singular unspecified 2 imperative  	I_LOC	null
113 יימי יימי יימי properName unspecified unspecified unspecified unspecified unspecified  	I_PERS	null
114 עלה עלה עלה verb masculine singular unspecified 2 imperative  	I_LOC	null
115 ליילי ליילי ליילי properName unspecified unspecified unspecified unspecified unspecified  	I_PERS	null
116 עלה עלה עלה verb masculine singular unspecified 2 imperative  	O	null
117 מ מ מהזרה preposition unspecified unspecified unspecified unspecified unspecified 0 
117 ה ה מהזרה definiteArticle unspecified unspecified unspecified unspecified unspecified 0 
117 הזרה זר מהזרה adjective feminine singular absolute unspecified unspecified  	O	null
118 ל ל לי preposition unspecified unspecified unspecified unspecified unspecified  
118 י י לי pronomial masculine-and-feminine singular unspecified 1 unspecified 0 	I_ORG	null
119 שחל שחל שחל properName unspecified unspecified unspecified unspecified unspecified  	I_ORG	null
120 נתהנה נתהנה נתהנה properName unspecified unspecified unspecified unspecified unspecified  	I_ORG	null
121 עלה עלה עלה verb masculine singular unspecified 2 imperative  	O	null
122 מזל מזל מזלי noun masculine singular absolute unspecified unspecified  
122 י י מזלי possessive masculine-and-feminine singular unspecified 1 unspecified 0 	O	null
123 עלה עלה עלה verb masculine singular unspecified 2 imperative  	I_LOC	null
124 אהבלי אהבלי אהבלי properName unspecified unspecified unspecified unspecified unspecified  	I_PERS	null
125 עלה עלה עלה verb masculine singular unspecified 2 imperative  	O	null
126 נייתי נייתי נייתי properName unspecified unspecified unspecified unspecified unspecified  	I_PERS	null
127 פדוניה פדוניה פדוניה properName unspecified unspecified unspecified unspecified unspecified  	I_PERS	null
128 עלה עלה עלה verb masculine singular unspecified 2 imperative  	O	null
129 מ מ מהזרה preposition unspecified unspecified unspecified unspecified unspecified 0 
129 ה ה מהזרה definiteArticle unspecified unspecified unspecified unspecified unspecified 0 
129 הזרה זר מהזרה adjective feminine singular absolute unspecified unspecified  	O	null
130 ל ל לי preposition unspecified unspecified unspecified unspecified unspecified  
130 י י לי pronomial masculine-and-feminine singular unspecified 1 unspecified 0 	O	null
131 על על על preposition unspecified unspecified unspecified unspecified unspecified  	O	null
132 כל כול כל quantifier unspecified unspecified construct unspecified unspecified  	O	null
133 ה ה הימים definiteArticle unspecified unspecified unspecified unspecified unspecified 0 
133 הימים יום הימים noun masculine plural absolute unspecified unspecified  	O	null
134 על על על preposition unspecified unspecified unspecified unspecified unspecified  	O	null
135 כל כול כל quantifier unspecified unspecified construct unspecified unspecified  	O	null
136 ה ה הלילות definiteArticle unspecified unspecified unspecified unspecified unspecified 0 
136 הלילות לילה הלילות noun masculine plural absolute unspecified unspecified  	O	null
137 על על על preposition unspecified unspecified unspecified unspecified unspecified  	O	null
138 כל כול כל quantifier unspecified unspecified construct unspecified unspecified  	O	null
139 מה מה מה interrogative unspecified unspecified unspecified unspecified unspecified  	O	null
140 שקרה שיקר שקרה verb feminine singular unspecified 3 past  	O	null
141 ל ל לי preposition unspecified unspecified unspecified unspecified unspecified  
141 י י לי pronomial masculine-and-feminine singular unspecified 1 unspecified 0 	O	null
142 כמה כמה כמה pronoun unspecified unspecified unspecified unspecified unspecified  	O	null
143 אוכל יכול אוכל modal masculine-and-feminine singular unspecified 1 future  	O	null
144 להישען נשען להישען verb unspecified unspecified unspecified unspecified infinitive  	O	null
145 על על על preposition unspecified unspecified unspecified unspecified unspecified  	O	null
146 מזל מזל מזלי noun masculine singular absolute unspecified unspecified  
146 י י מזלי possessive masculine-and-feminine singular unspecified 1 unspecified 0 	O	null
147 על על על preposition unspecified unspecified unspecified unspecified unspecified  	O	null
148 שגיאות שגיאה שגיאותיי noun feminine plural absolute unspecified unspecified  
148 י י שגיאותיי possessive masculine-and-feminine singular unspecified 1 unspecified 0 	O	null
149 ו ו ועל conjunction unspecified unspecified unspecified unspecified unspecified 0 
149 על על ועל preposition unspecified unspecified unspecified unspecified unspecified  	O	null
150 תמימות תמימות תמימותי noun feminine singular absolute unspecified unspecified  
150 י י תמימותי possessive masculine-and-feminine singular unspecified 1 unspecified 0 	O	null
151 ב ב בעולם preposition unspecified unspecified unspecified unspecified unspecified 0 
151 עולם עולם בעולם noun masculine singular construct unspecified unspecified  	O	null

