0 יש יש יש existential unspecified unspecified unspecified unspecified unspecified  	O	null
1 אבא אבא אבא noun masculine singular absolute unspecified unspecified  	O	null
2 אחד CARD1 אחד numeral masculine singular absolute unspecified unspecified  	O	null
3 ש ש שיושב relativizer/subordinatingConjunction unspecified unspecified unspecified unspecified unspecified 0 
3 יושב ישב שיושב verb masculine singular unspecified any beinoni  	O	null
4 ב ב במשרד preposition unspecified unspecified unspecified unspecified unspecified 0 
4 ה ה במשרד definiteArticle unspecified unspecified unspecified unspecified unspecified 0 
4 המשרד משרד במשרד noun masculine singular absolute unspecified unspecified  	I_ORG	null
5 ו ו ואבא conjunction unspecified unspecified unspecified unspecified unspecified 0 
5 אבא אבא ואבא properName unspecified unspecified unspecified unspecified unspecified  	I_ORG	null
6 אחד CARD1 אחד numeral masculine singular absolute unspecified unspecified  	I_LOC	null
7 עובד עובד עובד verb masculine singular unspecified 3 past  	O	null
8 לבד לבד לבד adverb unspecified unspecified unspecified unspecified unspecified  	O	null
9 אבא אבא אבא noun masculine singular absolute unspecified unspecified  	O	null
10 של של שלו shel-preposition unspecified unspecified unspecified unspecified unspecified  
10 ו ו שלו pronomial masculine singular unspecified 3 unspecified 0 	O	null
11 מוכר מכר מוכר verb masculine singular unspecified any beinoni  	O	null
12 ירקות ירק ירקות noun masculine plural absolute unspecified unspecified  	O	null
13 ו ו ואבא conjunction unspecified unspecified unspecified unspecified unspecified 0 
13 אבא אבא ואבא noun masculine singular absolute unspecified unspecified  	O	null
14 של של שלה shel-preposition unspecified unspecified unspecified unspecified unspecified  
14 ה ה שלה pronomial feminine singular unspecified 3 unspecified 0 	O	null
15 חולב חלב חולב verb masculine singular unspecified any beinoni  	O	null
16 פרות פרה פרות noun feminine plural absolute unspecified unspecified  	O	null
17 אבא אבא אבא properName unspecified unspecified unspecified unspecified unspecified  	O	null
18 אחד CARD1 אחד numeral masculine singular absolute unspecified unspecified  	O	null
19 ב ב בשמיים preposition unspecified unspecified unspecified unspecified unspecified 0 
19 ה ה בשמיים definiteArticle unspecified unspecified unspecified unspecified unspecified 0 
19 השמיים שמיים בשמיים noun masculine plural absolute unspecified unspecified  	O	null
20 טס טס טס verb masculine singular unspecified 3 past  	O	null
21 ו ו ואבא conjunction unspecified unspecified unspecified unspecified unspecified 0 
21 אבא אבא ואבא properName unspecified unspecified unspecified unspecified unspecified  	O	null
22 אחד CARD1 אחד numeral masculine singular absolute unspecified unspecified  	O	null
23 בלש בלש בלש verb masculine singular unspecified 3 past  	O	null
24 הס הס הס properName unspecified unspecified unspecified unspecified unspecified  	I_PERS	null
25 הס הס הס properName unspecified unspecified unspecified unspecified unspecified  	I_PERS	null
26 אבא אבא אבא properName unspecified unspecified unspecified unspecified unspecified  	I_PERS	null
27 של של של shel-preposition unspecified unspecified unspecified unspecified unspecified  	O	null
28 גיל גיל גיל noun masculine singular construct unspecified unspecified  	O	null
29 עובד עובד עובד noun masculine singular absolute unspecified unspecified  	O	null
30 ב ב בעיתון preposition unspecified unspecified unspecified unspecified unspecified 0 
30 ה ה בעיתון definiteArticle unspecified unspecified unspecified unspecified unspecified 0 
30 העיתון עיתון בעיתון noun masculine singular absolute unspecified unspecified  	O	null
31 ו ו ואבא conjunction unspecified unspecified unspecified unspecified unspecified 0 
31 אבא אבא ואבא noun masculine singular absolute unspecified unspecified  	O	null
32 של של של shel-preposition unspecified unspecified unspecified unspecified unspecified  	O	null
33 שיר שיר שיר properName unspecified unspecified unspecified unspecified unspecified  	I_PERS	null
34 מ מ מנפח preposition unspecified unspecified unspecified unspecified unspecified 0 
34 נפח נפח מנפח noun masculine singular construct unspecified unspecified  	O	null
35 בלון בלון בלון noun masculine singular absolute unspecified unspecified  	O	null

0 אבא אבא אבא noun masculine singular absolute unspecified unspecified  	O	null
1 של של שלי shel-preposition unspecified unspecified unspecified unspecified unspecified  
1 י י שלי pronomial masculine-and-feminine singular unspecified 1 unspecified 0 	O	null
2 הכי הכי הכי adverb unspecified unspecified unspecified unspecified unspecified  	O	null
3 טוב טוב טוב adjective masculine singular absolute unspecified unspecified  	O	null
4 ב ב בעולם preposition unspecified unspecified unspecified unspecified unspecified 0 
4 עולם עולם בעולם noun masculine singular construct unspecified unspecified  	O	null
5 אבא אבא אבא noun masculine singular absolute unspecified unspecified  	O	null
6 של של שלי shel-preposition unspecified unspecified unspecified unspecified unspecified  
6 י י שלי pronomial masculine-and-feminine singular unspecified 1 unspecified 0 	O	null
7 הוא הוא הוא pronoun masculine singular unspecified 3 unspecified  	O	null
8 קודם קודם קודם adverb unspecified unspecified unspecified unspecified unspecified  	O	null
9 בן בן בן noun masculine singular construct unspecified unspecified  	O	null
10 אדם אדם אדם noun masculine singular absolute unspecified unspecified  	O	null
11 רגיש רגיש רגיש adjective masculine singular absolute unspecified unspecified  	O	null
12 מפנק פינק מפנק verb masculine singular unspecified any beinoni  	O	null
13 מקשיב הקשיב מקשיב verb masculine singular unspecified any beinoni  	O	null
14 ו ו ומתחשב conjunction unspecified unspecified unspecified unspecified unspecified 0 
14 מתחשב התחשב ומתחשב verb masculine singular unspecified any beinoni  	O	null
15 אבא אבא אבא properName unspecified unspecified unspecified unspecified unspecified  	I_LOC	null
16 של של שלי shel-preposition unspecified unspecified unspecified unspecified unspecified  
16 י י שלי pronomial masculine-and-feminine singular unspecified 1 unspecified 0 	O	null
17 את את אותך at-preposition unspecified unspecified unspecified unspecified unspecified  
17 ך ך אותך pronomial masculine singular unspecified 2 unspecified 0 	O	null
18 אני הוא אני pronoun masculine-and-feminine singular unspecified 1 unspecified  	O	null
19 אוהב אהב אוהב verb masculine singular unspecified any beinoni  	O	null

0 יש יש יש existential unspecified unspecified unspecified unspecified unspecified  	O	null
1 אבא אבא אבא noun masculine singular absolute unspecified unspecified  	O	null
2 אחד CARD1 אחד numeral masculine singular absolute unspecified unspecified  	O	null
3 ש ש ששר relativizer/subordinatingConjunction unspecified unspecified unspecified unspecified unspecified 0 
3 שר שר ששר noun masculine singular construct unspecified unspecified  	O	null
4 שירים שיר שירים noun masculine plural absolute unspecified unspecified  	O	null
5 ו ו ואבא conjunction unspecified unspecified unspecified unspecified unspecified 0 
5 אבא אבא ואבא properName unspecified unspecified unspecified unspecified unspecified  	I_ORG	null
6 אחד איחד אחד verb masculine singular unspecified 3 past  	O	null
7 מנהל מנהל מנהל noun masculine singular construct unspecified unspecified  	O	null
8 עסקים עסק עסקים noun masculine plural absolute unspecified unspecified  	O	null
9 אבא אבא אבא properName unspecified unspecified unspecified unspecified unspecified  	O	null
10 של של שלו shel-preposition unspecified unspecified unspecified unspecified unspecified  
10 ו ו שלו pronomial masculine singular unspecified 3 unspecified 0 	O	null
11 עובד עובד עובד verb masculine singular unspecified 3 past  	O	null
12 ב ב בגינה preposition unspecified unspecified unspecified unspecified unspecified 0 
12 גינה גינה בגינה noun feminine singular absolute unspecified unspecified  	O	null
13 ו ו ואבא conjunction unspecified unspecified unspecified unspecified unspecified 0 
13 אבא אבא ואבא noun masculine singular absolute unspecified unspecified  	O	null
14 של של שלה shel-preposition unspecified unspecified unspecified unspecified unspecified  
14 ה ה שלה pronomial feminine singular unspecified 3 unspecified 0 	O	null
15 מוכר מכר מוכר verb masculine singular unspecified any beinoni  	O	null
16 גלידה גלידה גלידה noun feminine singular absolute unspecified unspecified  	O	null
17 אבא אבא אבא properName unspecified unspecified unspecified unspecified unspecified  	O	null
18 אחד CARD1 אחד numeral masculine singular absolute unspecified unspecified  	O	null
19 מציל הציל מציל verb masculine singular unspecified any beinoni  	O	null
20 ב ב בים preposition unspecified unspecified unspecified unspecified unspecified 0 
20 ה ה בים definiteArticle unspecified unspecified unspecified unspecified unspecified 0 
20 הים ים בים noun masculine singular absolute unspecified unspecified  	O	null
21 ו ו ואבא conjunction unspecified unspecified unspecified unspecified unspecified 0 
21 אבא אבא ואבא properName unspecified unspecified unspecified unspecified unspecified  	O	null
22 אחד איחד אחד verb masculine singular unspecified 3 past  	O	null
23 מדען מדען מדען noun masculine singular absolute unspecified unspecified  	O	null
24 מפורסם מפורסם מפורסם adjective masculine singular absolute unspecified unspecified  	O	null
25 אבא אבא אבא noun masculine singular absolute unspecified unspecified  	O	null
26 של של של shel-preposition unspecified unspecified unspecified unspecified unspecified  	O	null
27 מיכל מיכל מיכל properName feminine singular unspecified unspecified unspecified  	I_PERS	null
28 רופא רופא רופא noun masculine singular construct unspecified unspecified  	O	null
29 ילדים ילד ילדים noun masculine plural absolute unspecified unspecified  	O	null
30 ו ו ואבא conjunction unspecified unspecified unspecified unspecified unspecified 0 
30 אבא אבא ואבא noun masculine singular absolute unspecified unspecified  	O	null
31 של של של shel-preposition unspecified unspecified unspecified unspecified unspecified  	O	null
32 טל טל טל properName unspecified unspecified unspecified unspecified unspecified  	I_PERS	null
33 מדריך מדריך מדריך noun masculine singular absolute unspecified unspecified  	O	null
34 תירים תירים תירים adjective masculine singular absolute unspecified unspecified  	O	null

0 אבא אבא אבא properName unspecified unspecified unspecified unspecified unspecified  	I_PERS	null
1 ש ש שלי... relativizer/subordinatingConjunction unspecified unspecified unspecified unspecified unspecified 0 
1 לי... לי... שלי... adjective masculine singular construct unspecified unspecified  	O	null

0 אבא אבא אבא properName unspecified unspecified unspecified unspecified unspecified  	O	null
1 ' ' ' punctuation unspecified unspecified unspecified unspecified unspecified  	O	null
2 לה לה לה properName unspecified unspecified unspecified unspecified unspecified  	I_PERS	null
3 בא בא בא verb masculine singular unspecified 3 past  	O	null
4 נרקוד רקד נרקוד verb masculine-and-feminine plural unspecified 1 future  	O	null
5 ביחד ביחד ביחד adverb unspecified unspecified unspecified unspecified unspecified  	O	null
6 נטוס טס נטוס verb masculine-and-feminine plural unspecified 1 future  	O	null
7 ל ל לשמיים preposition unspecified unspecified unspecified unspecified unspecified 0 
7 שמיים שמיים לשמיים noun masculine plural absolute unspecified unspecified  	O	null
8 בלי בלי בלי preposition unspecified unspecified unspecified unspecified unspecified  	O	null
9 פחד פחד פחד noun masculine singular absolute unspecified unspecified  	O	null
10 מלמעלה מלמעלה מלמעלה adverb unspecified unspecified unspecified unspecified unspecified  	O	null
11 אסתכל הסתכל אסתכל verb masculine-and-feminine singular unspecified 1 future  	O	null
12 אחר אחר אחר preposition unspecified unspecified unspecified unspecified unspecified  	O	null
13 כך כך כך pronoun unspecified unspecified unspecified unspecified unspecified  	O	null
14 על על על preposition unspecified unspecified unspecified unspecified unspecified  	O	null
15 ה ה הדשא definiteArticle unspecified unspecified unspecified unspecified unspecified 0 
15 הדשא דשא הדשא noun masculine singular absolute unspecified unspecified  	O	null
16 נתגלגל התגלגל נתגלגל verb masculine singular unspecified 3 past  	O	null
17 אבא אבא אבא properName unspecified unspecified unspecified unspecified unspecified  	I_LOC	null
18 של של שלי shel-preposition unspecified unspecified unspecified unspecified unspecified  
18 י י שלי pronomial masculine-and-feminine singular unspecified 1 unspecified 0 	O	null
19 תמיד תמיד תמיד adverb unspecified unspecified unspecified unspecified unspecified  	O	null
20 הוא הוא הוא pronoun masculine singular unspecified 3 unspecified  	O	null
21 את את איתי at-preposition unspecified unspecified unspecified unspecified unspecified  
21 י י איתי pronomial masculine-and-feminine singular unspecified 1 unspecified 0 	O	null
22 אבא אבא אבא noun masculine singular absolute unspecified unspecified  	O	null
23 של של שלי shel-preposition unspecified unspecified unspecified unspecified unspecified  
23 י י שלי pronomial masculine-and-feminine singular unspecified 1 unspecified 0 	O	null
24 תמיד תמיד תמיד adverb unspecified unspecified unspecified unspecified unspecified  	O	null
25 ב ב בשבילי preposition unspecified unspecified unspecified unspecified unspecified 0 
25 שבילי שביל בשבילי noun masculine plural construct unspecified unspecified  	O	null

