0 so so so foreign unspecified unspecified unspecified unspecified unspecified  	O	null
1 , , , punctuation unspecified unspecified unspecified unspecified unspecified  	O	null
2 you you you foreign unspecified unspecified unspecified unspecified unspecified  	O	null
3 said said said foreign unspecified unspecified unspecified unspecified unspecified  	O	null
4 " " " punctuation unspecified unspecified unspecified unspecified unspecified  	O	null
5 don don don foreign unspecified unspecified unspecified unspecified unspecified  	I_ORG	null
6 ' ' ' punctuation unspecified unspecified unspecified unspecified unspecified  	O	null
7 t t t foreign unspecified unspecified unspecified unspecified unspecified  	I_ORG	null
8 be be be foreign unspecified unspecified unspecified unspecified unspecified  	I_ORG	null
9 decieved decieved decieved foreign unspecified unspecified unspecified unspecified unspecified  	I_ORG	null
10 " " " punctuation unspecified unspecified unspecified unspecified unspecified  	O	null
11 when when when foreign unspecified unspecified unspecified unspecified unspecified  	I_ORG	null
12 summer summer summer foreign unspecified unspecified unspecified unspecified unspecified  	I_ORG	null
13 comes comes comes foreign unspecified unspecified unspecified unspecified unspecified  	I_ORG	null
14 you you you foreign unspecified unspecified unspecified unspecified unspecified  	I_ORG	null
15 leave leave leave foreign unspecified unspecified unspecified unspecified unspecified  	I_ORG	null
16 shine shine shine foreign unspecified unspecified unspecified unspecified unspecified  	I_ORG	null
17 your your your foreign unspecified unspecified unspecified unspecified unspecified  	I_ORG	null
18 holy holy holy foreign unspecified unspecified unspecified unspecified unspecified  	I_ORG	null
19 light light light foreign unspecified unspecified unspecified unspecified unspecified  	I_ORG	null
20 on on on foreign unspecified unspecified unspecified unspecified unspecified  	I_ORG	null
21 me me me foreign unspecified unspecified unspecified unspecified unspecified  	I_ORG	null
22 . . . punctuation unspecified unspecified unspecified unspecified unspecified  	O	null

0 get get get foreign unspecified unspecified unspecified unspecified unspecified  	I_ORG	null
1 undressed undressed undressed foreign unspecified unspecified unspecified unspecified unspecified  	I_ORG	null
2 is is is foreign unspecified unspecified unspecified unspecified unspecified  	I_ORG	null
3 it it it foreign unspecified unspecified unspecified unspecified unspecified  	I_ORG	null
4 me me me foreign unspecified unspecified unspecified unspecified unspecified  	I_ORG	null
5 ? ? ? punctuation unspecified unspecified unspecified unspecified unspecified  	O	null

0 or or or foreign unspecified unspecified unspecified unspecified unspecified  	I_ORG	null
1 is is is foreign unspecified unspecified unspecified unspecified unspecified  	I_ORG	null
2 awfully awfully awfully foreign unspecified unspecified unspecified unspecified unspecified  	I_ORG	null
3 hot hot hot foreign unspecified unspecified unspecified unspecified unspecified  	I_ORG	null
4 in in in foreign unspecified unspecified unspecified unspecified unspecified  	I_ORG	null
5 here here here foreign unspecified unspecified unspecified unspecified unspecified  	I_ORG	null
6 ? ? ? punctuation unspecified unspecified unspecified unspecified unspecified  	O	null

0 can can can foreign unspecified unspecified unspecified unspecified unspecified  	I_ORG	null
1 feel feel feel foreign unspecified unspecified unspecified unspecified unspecified  	I_ORG	null
2 my my my foreign unspecified unspecified unspecified unspecified unspecified  	I_ORG	null
3 heart heart heart foreign unspecified unspecified unspecified unspecified unspecified  	I_ORG	null
4 a a a foreign unspecified unspecified unspecified unspecified unspecified  	I_ORG	null
5 - - - punctuation unspecified unspecified unspecified unspecified unspecified  	O	null
6 beatin beatin beatin foreign unspecified unspecified unspecified unspecified unspecified  	O	null
7 ' ' ' punctuation unspecified unspecified unspecified unspecified unspecified  	O	null
8 ? ? ? punctuation unspecified unspecified unspecified unspecified unspecified  	O	null
9 knees knees knees foreign unspecified unspecified unspecified unspecified unspecified  	O	null
10 are are are foreign unspecified unspecified unspecified unspecified unspecified  	O	null
11 shakin shakin shakin foreign unspecified unspecified unspecified unspecified unspecified  	O	null
12 ' ' ' punctuation unspecified unspecified unspecified unspecified unspecified  	O	null
13 my my my foreign unspecified unspecified unspecified unspecified unspecified  	I_ORG	null
14 my my my foreign unspecified unspecified unspecified unspecified unspecified  	I_ORG	null

0 and and and foreign unspecified unspecified unspecified unspecified unspecified  	I_ORG	null
1 you you you foreign unspecified unspecified unspecified unspecified unspecified  	I_ORG	null
2 you you you foreign unspecified unspecified unspecified unspecified unspecified  	I_ORG	null
3 are are are foreign unspecified unspecified unspecified unspecified unspecified  	I_ORG	null
4 all all all foreign unspecified unspecified unspecified unspecified unspecified  	I_ORG	null
5 i i i foreign unspecified unspecified unspecified unspecified unspecified  	I_ORG	null
6 need need need foreign unspecified unspecified unspecified unspecified unspecified  	I_ORG	null
7 and and and foreign unspecified unspecified unspecified unspecified unspecified  	I_ORG	null
8 i'm i'm i'm foreign unspecified unspecified unspecified unspecified unspecified  	I_ORG	null
9 a a a foreign unspecified unspecified unspecified unspecified unspecified  	I_ORG	null
10 little little little foreign unspecified unspecified unspecified unspecified unspecified  	I_ORG	null
11 kid kid kid foreign unspecified unspecified unspecified unspecified unspecified  	I_ORG	null
12 and and and foreign unspecified unspecified unspecified unspecified unspecified  	I_ORG	null
13 i i i foreign unspecified unspecified unspecified unspecified unspecified  	I_ORG	null
14 don't don't don't foreign unspecified unspecified unspecified unspecified unspecified  	I_ORG	null
15 know know know foreign unspecified unspecified unspecified unspecified unspecified  	I_ORG	null
16 what what what foreign unspecified unspecified unspecified unspecified unspecified  	I_ORG	null
17 you you you foreign unspecified unspecified unspecified unspecified unspecified  	I_ORG	null
18 mean mean mean foreign unspecified unspecified unspecified unspecified unspecified  	I_ORG	null
19 love love love foreign unspecified unspecified unspecified unspecified unspecified  	I_ORG	null
20 well well well foreign unspecified unspecified unspecified unspecified unspecified  	I_ORG	null
21 it's it's it's foreign unspecified unspecified unspecified unspecified unspecified  	I_ORG	null
22 a a a foreign unspecified unspecified unspecified unspecified unspecified  	I_ORG	null
23 tricky tricky tricky foreign unspecified unspecified unspecified unspecified unspecified  	I_ORG	null
24 thing thing thing foreign unspecified unspecified unspecified unspecified unspecified  	I_ORG	null
25 it's it's it's foreign unspecified unspecified unspecified unspecified unspecified  	I_ORG	null
26 never never never foreign unspecified unspecified unspecified unspecified unspecified  	I_ORG	null
27 what what what foreign unspecified unspecified unspecified unspecified unspecified  	I_ORG	null
28 it it it foreign unspecified unspecified unspecified unspecified unspecified  	I_ORG	null
29 seems seems seems foreign unspecified unspecified unspecified unspecified unspecified  	I_ORG	null
30 and and and foreign unspecified unspecified unspecified unspecified unspecified  	I_ORG	null
31 i i i foreign unspecified unspecified unspecified unspecified unspecified  	I_ORG	null
32 don't don't don't foreign unspecified unspecified unspecified unspecified unspecified  	I_ORG	null
33 know know know foreign unspecified unspecified unspecified unspecified unspecified  	I_ORG	null
34 what what what foreign unspecified unspecified unspecified unspecified unspecified  	I_ORG	null
35 you you you foreign unspecified unspecified unspecified unspecified unspecified  	I_ORG	null
36 mean mean mean foreign unspecified unspecified unspecified unspecified unspecified  	I_ORG	null
37 . . . punctuation unspecified unspecified unspecified unspecified unspecified  	O	null

0 close close close foreign unspecified unspecified unspecified unspecified unspecified  	I_ORG	null
1 your your your foreign unspecified unspecified unspecified unspecified unspecified  	I_ORG	null
2 weary weary weary foreign unspecified unspecified unspecified unspecified unspecified  	I_ORG	null
3 eyes eyes eyes foreign unspecified unspecified unspecified unspecified unspecified  	I_ORG	null
4 to to to foreign unspecified unspecified unspecified unspecified unspecified  	I_ORG	null
5 sleep sleep sleep foreign unspecified unspecified unspecified unspecified unspecified  	I_ORG	null
6 come come come foreign unspecified unspecified unspecified unspecified unspecified  	I_ORG	null
7 morning morning morning foreign unspecified unspecified unspecified unspecified unspecified  	I_ORG	null
8 i'll i'll i'll foreign unspecified unspecified unspecified unspecified unspecified  	I_ORG	null
9 translate translate translate foreign unspecified unspecified unspecified unspecified unspecified  	I_ORG	null
10 your your your foreign unspecified unspecified unspecified unspecified unspecified  	I_ORG	null
11 dreams dreams dreams foreign unspecified unspecified unspecified unspecified unspecified  	I_ORG	null
12 you you you foreign unspecified unspecified unspecified unspecified unspecified  	I_ORG	null
13 tell tell tell foreign unspecified unspecified unspecified unspecified unspecified  	I_ORG	null
14 me me me foreign unspecified unspecified unspecified unspecified unspecified  	I_ORG	null
15 if if if foreign unspecified unspecified unspecified unspecified unspecified  	I_ORG	null
16 you you you foreign unspecified unspecified unspecified unspecified unspecified  	I_ORG	null
17 believe believe believe foreign unspecified unspecified unspecified unspecified unspecified  	I_ORG	null
18 , , , punctuation unspecified unspecified unspecified unspecified unspecified  	O	null
19 do do do foreign unspecified unspecified unspecified unspecified unspecified  	O	null
20 you you you foreign unspecified unspecified unspecified unspecified unspecified  	O	null
21 ? ? ? punctuation unspecified unspecified unspecified unspecified unspecified  	O	null

0 well well well foreign unspecified unspecified unspecified unspecified unspecified  	I_ORG	null
1 some some some foreign unspecified unspecified unspecified unspecified unspecified  	I_ORG	null
2 things things things foreign unspecified unspecified unspecified unspecified unspecified  	I_ORG	null
3 I I I foreign unspecified unspecified unspecified unspecified unspecified  	I_ORG	null
4 ' ' ' punctuation unspecified unspecified unspecified unspecified unspecified  	O	null
5 ll ll ll foreign unspecified unspecified unspecified unspecified unspecified  	I_ORG	null
6 never never never foreign unspecified unspecified unspecified unspecified unspecified  	I_ORG	null
7 see see see foreign unspecified unspecified unspecified unspecified unspecified  	I_ORG	null
8 you you you foreign unspecified unspecified unspecified unspecified unspecified  	I_ORG	null
9 tell tell tell foreign unspecified unspecified unspecified unspecified unspecified  	I_ORG	null
10 me me me foreign unspecified unspecified unspecified unspecified unspecified  	I_ORG	null
11 what what what foreign unspecified unspecified unspecified unspecified unspecified  	I_ORG	null
12 i'm i'm i'm foreign unspecified unspecified unspecified unspecified unspecified  	I_ORG	null
13 missing missing missing foreign unspecified unspecified unspecified unspecified unspecified  	I_ORG	null
14 . . . punctuation unspecified unspecified unspecified unspecified unspecified  	O	null

0 can can can foreign unspecified unspecified unspecified unspecified unspecified  	I_ORG	null
1 you you you foreign unspecified unspecified unspecified unspecified unspecified  	I_ORG	null
2 feel feel feel foreign unspecified unspecified unspecified unspecified unspecified  	I_ORG	null
3 my my my foreign unspecified unspecified unspecified unspecified unspecified  	I_ORG	null
4 heart heart heart foreign unspecified unspecified unspecified unspecified unspecified  	I_ORG	null
5 a a a foreign unspecified unspecified unspecified unspecified unspecified  	I_ORG	null
6 - - - punctuation unspecified unspecified unspecified unspecified unspecified  	O	null
7 beatin beatin beatin foreign unspecified unspecified unspecified unspecified unspecified  	O	null
8 ' ' ' punctuation unspecified unspecified unspecified unspecified unspecified  	O	null
9 ? ? ? punctuation unspecified unspecified unspecified unspecified unspecified  	O	null
10 knees knees knees foreign unspecified unspecified unspecified unspecified unspecified  	O	null
11 are are are foreign unspecified unspecified unspecified unspecified unspecified  	O	null
12 shakin shakin shakin foreign unspecified unspecified unspecified unspecified unspecified  	O	null
13 ' ' ' punctuation unspecified unspecified unspecified unspecified unspecified  	O	null
14 my my my foreign unspecified unspecified unspecified unspecified unspecified  	O	null
15 my my my foreign unspecified unspecified unspecified unspecified unspecified  	O	null
16 ... ... ... punctuation unspecified unspecified unspecified unspecified unspecified  	O	null

0 and and and foreign unspecified unspecified unspecified unspecified unspecified  	I_ORG	null
1 you you you foreign unspecified unspecified unspecified unspecified unspecified  	I_ORG	null
2 you you you foreign unspecified unspecified unspecified unspecified unspecified  	I_ORG	null
3 are are are foreign unspecified unspecified unspecified unspecified unspecified  	I_ORG	null
4 all all all foreign unspecified unspecified unspecified unspecified unspecified  	I_ORG	null
5 i i i foreign unspecified unspecified unspecified unspecified unspecified  	I_ORG	null
6 need need need foreign unspecified unspecified unspecified unspecified unspecified  	I_ORG	null
7 ... ... ... punctuation unspecified unspecified unspecified unspecified unspecified  	O	null

0 well well well foreign unspecified unspecified unspecified unspecified unspecified  	I_ORG	null
1 i'm i'm i'm foreign unspecified unspecified unspecified unspecified unspecified  	I_ORG	null
2 sorry sorry sorry foreign unspecified unspecified unspecified unspecified unspecified  	I_ORG	null
3 if if if foreign unspecified unspecified unspecified unspecified unspecified  	I_ORG	null
4 sometimes sometimes sometimes foreign unspecified unspecified unspecified unspecified unspecified  	I_ORG	null
5 still still still foreign unspecified unspecified unspecified unspecified unspecified  	I_ORG	null
6 i i i foreign unspecified unspecified unspecified unspecified unspecified  	I_ORG	null
7 act act act foreign unspecified unspecified unspecified unspecified unspecified  	I_ORG	null
8 a a a foreign unspecified unspecified unspecified unspecified unspecified  	I_ORG	null
9 little little little foreign unspecified unspecified unspecified unspecified unspecified  	I_ORG	null
10 weird weird weird foreign unspecified unspecified unspecified unspecified unspecified  	I_ORG	null
11 i i i foreign unspecified unspecified unspecified unspecified unspecified  	I_ORG	null
12 don't don't don't foreign unspecified unspecified unspecified unspecified unspecified  	I_ORG	null
13 know know know foreign unspecified unspecified unspecified unspecified unspecified  	I_ORG	null
14 how how how foreign unspecified unspecified unspecified unspecified unspecified  	I_ORG	null
15 i i i foreign unspecified unspecified unspecified unspecified unspecified  	I_ORG	null
16 feel feel feel foreign unspecified unspecified unspecified unspecified unspecified  	I_ORG	null
17 take take take foreign unspecified unspecified unspecified unspecified unspecified  	I_ORG	null
18 now now now foreign unspecified unspecified unspecified unspecified unspecified  	I_ORG	null
19 anything anything anything foreign unspecified unspecified unspecified unspecified unspecified  	I_ORG	null
20 from from from foreign unspecified unspecified unspecified unspecified unspecified  	I_ORG	null
21 me me me foreign unspecified unspecified unspecified unspecified unspecified  	I_ORG	null
22 i'll i'll i'll foreign unspecified unspecified unspecified unspecified unspecified  	I_ORG	null
23 give give give foreign unspecified unspecified unspecified unspecified unspecified  	I_ORG	null
24 you you you foreign unspecified unspecified unspecified unspecified unspecified  	I_ORG	null
25 whatever's whatever's whatever's foreign unspecified unspecified unspecified unspecified unspecified  	I_ORG	null
26 missing missing missing foreign unspecified unspecified unspecified unspecified unspecified  	I_ORG	null
27 can can can foreign unspecified unspecified unspecified unspecified unspecified  	I_ORG	null
28 you you you foreign unspecified unspecified unspecified unspecified unspecified  	I_ORG	null
29 feel feel feel foreign unspecified unspecified unspecified unspecified unspecified  	I_ORG	null
30 my my my foreign unspecified unspecified unspecified unspecified unspecified  	I_ORG	null
31 heart heart heart foreign unspecified unspecified unspecified unspecified unspecified  	I_ORG	null
32 a a a foreign unspecified unspecified unspecified unspecified unspecified  	I_ORG	null
33 - - - punctuation unspecified unspecified unspecified unspecified unspecified  	O	null
34 beatin beatin beatin foreign unspecified unspecified unspecified unspecified unspecified  	O	null
35 ' ' ' punctuation unspecified unspecified unspecified unspecified unspecified  	O	null
36 ? ? ? punctuation unspecified unspecified unspecified unspecified unspecified  	O	null
37 knees knees knees foreign unspecified unspecified unspecified unspecified unspecified  	O	null
38 are are are foreign unspecified unspecified unspecified unspecified unspecified  	O	null
39 shakin shakin shakin foreign unspecified unspecified unspecified unspecified unspecified  	O	null
40 ' ' ' punctuation unspecified unspecified unspecified unspecified unspecified  	O	null
41 my my my foreign unspecified unspecified unspecified unspecified unspecified  	O	null
42 my my my foreign unspecified unspecified unspecified unspecified unspecified  	O	null
43 ..... ..... ..... punctuation unspecified unspecified unspecified unspecified unspecified  	O	null

