0 שמש שמש שמש properName unspecified unspecified unspecified unspecified unspecified  	I_PERS	null
1 שמש שמש שמש properName unspecified unspecified unspecified unspecified unspecified  	I_PERS	null
2 רד ירד רד verb masculine singular unspecified 2 imperative  	O	null
3 ל ל לים preposition unspecified unspecified unspecified unspecified unspecified 0 
3 ה ה לים definiteArticle unspecified unspecified unspecified unspecified unspecified 0 
3 הים ים לים noun masculine singular absolute unspecified unspecified  	O	null
4 , , , punctuation unspecified unspecified unspecified unspecified unspecified  	O	null
5 רוח רוח רוח noun feminine singular construct unspecified unspecified  	O	null
6 רוח רוח רוח noun feminine singular absolute unspecified unspecified  	O	null
7 קל קל קל adjective masculine singular absolute unspecified unspecified  	O	null
8 יהום יהום יהום preposition unspecified unspecified unspecified unspecified unspecified  	O	null
9 מי מי מי interrogative unspecified unspecified unspecified unspecified unspecified  	O	null
10 חולם חלם חולם verb masculine singular unspecified any beinoni  	O	null
11 חולם חלם חולם verb masculine singular unspecified any beinoni  	O	null
12 על על עלייך preposition unspecified unspecified unspecified unspecified unspecified  
12 ך ך עלייך pronomial feminine singular unspecified 2 unspecified 0 	O	null
13 ב ב במשלט preposition unspecified unspecified unspecified unspecified unspecified 0 
13 ה ה במשלט definiteArticle unspecified unspecified unspecified unspecified unspecified 0 
13 המשלט משלט במשלט noun masculine singular absolute unspecified unspecified  	O	null
14 מ מ משלט preposition unspecified unspecified unspecified unspecified unspecified 0 
14 שלט שלט משלט noun masculine singular construct unspecified unspecified  	O	null
15 עירום עירום עירום noun masculine singular absolute unspecified unspecified  	O	null
16 . . . punctuation unspecified unspecified unspecified unspecified unspecified  	O	null

0 שני CARD2 שני numeral masculine dual construct unspecified unspecified  	O	null
1 אורות אור אורות noun masculine plural absolute unspecified unspecified  	O	null
2 ב ב בליל preposition unspecified unspecified unspecified unspecified unspecified 0 
2 ליל ליל בליל noun masculine singular construct unspecified unspecified  	O	null
3 בליל בליל בליל noun masculine singular construct unspecified unspecified  	O	null
4 בליל בליל בליל noun masculine singular absolute unspecified unspecified  	O	null
5 ל ל לי preposition unspecified unspecified unspecified unspecified unspecified  
5 י י לי pronomial masculine-and-feminine singular unspecified 1 unspecified 0 	O	null
6 רומזים רמז רומזים verb masculine plural unspecified any beinoni  	O	null
7 רומזים רמז רומזים verb masculine plural unspecified any beinoni  	O	null
8 פתאום פתאום פתאום adverb unspecified unspecified unspecified unspecified unspecified  	O	null
9 . . . punctuation unspecified unspecified unspecified unspecified unspecified  	O	null

0 מה מה מה interrogative unspecified unspecified unspecified unspecified unspecified  	O	null
1 אומרות אמר אומרות verb feminine plural unspecified any beinoni  	O	null
2 עיני עין עינייך noun feminine plural absolute unspecified unspecified  
2 ך ך עינייך possessive feminine singular unspecified 2 unspecified 0 	O	null
3 עיני עין עינייך noun feminine plural absolute unspecified unspecified  
3 ך ך עינייך possessive feminine singular unspecified 2 unspecified 0 	O	null
4 עיני עין עינייך noun feminine plural absolute unspecified unspecified  
4 ך ך עינייך possessive feminine singular unspecified 2 unspecified 0 	O	null
5 בלי בלי בלי conjunction unspecified unspecified unspecified unspecified unspecified  	O	null
6 לומר אמר לומר verb unspecified unspecified unspecified unspecified infinitive  	O	null
7 עד עד עד preposition unspecified unspecified unspecified unspecified unspecified  	I_LOC	null
8 תום תום תום properName unspecified unspecified unspecified unspecified unspecified  	I_PERS	null
9 , , , punctuation unspecified unspecified unspecified unspecified unspecified  	O	null
10 עד עד עד preposition unspecified unspecified unspecified unspecified unspecified  	I_LOC	null
11 תום תום תום properName unspecified unspecified unspecified unspecified unspecified  	I_PERS	null
12 . . . punctuation unspecified unspecified unspecified unspecified unspecified  	O	null

0 בין בין בין preposition unspecified unspecified unspecified unspecified unspecified  	O	null
1 סלעים סלע סלעים noun masculine plural absolute unspecified unspecified  	O	null
2 סלעים סלע סלעים noun masculine plural absolute unspecified unspecified  	O	null
3 ו ו והר conjunction unspecified unspecified unspecified unspecified unspecified 0 
3 הר הר והר noun masculine singular construct unspecified unspecified  	O	null
4 עץ עץ עץ noun masculine singular absolute unspecified unspecified  	O	null
5 בודד בודד בודד adjective masculine singular absolute unspecified unspecified  	O	null
6 בודד בודד בודד adjective masculine singular absolute unspecified unspecified  	O	null
7 ינום נם ינום verb masculine singular unspecified 3 future  	O	null
8 . . . punctuation unspecified unspecified unspecified unspecified unspecified  	O	null

0 מי מי מי interrogative unspecified unspecified unspecified unspecified unspecified  	O	null
1 הולך הלך הולך verb masculine singular unspecified any beinoni  	O	null
2 הולך הלך הולך verb masculine singular unspecified any beinoni  	O	null
3 אל אל אלייך preposition unspecified unspecified unspecified unspecified unspecified  
3 ך ך אלייך pronomial feminine singular unspecified 2 unspecified 0 	O	null
4 עם עם עם preposition unspecified unspecified unspecified unspecified unspecified  	O	null
5 ערוב ערוב ערוב noun masculine singular absolute unspecified unspecified  	O	null
6 ערוב ערוב ערוב noun masculine singular absolute unspecified unspecified  	O	null
7 היום היום היום adverb unspecified unspecified unspecified unspecified unspecified  	O	null
8 ? ? ? punctuation unspecified unspecified unspecified unspecified unspecified  	O	null

0 שני שני שני noun masculine singular construct unspecified unspecified  	O	null
1 אורות אורות אורות properName unspecified unspecified unspecified unspecified unspecified  	I_ORG	null
2 בליל... בליל... בליל... properName unspecified unspecified unspecified unspecified unspecified  	I_ORG	null

0 בוקר בוקר בוקר noun masculine singular absolute unspecified unspecified  	O	null
1 בוקר בוקר בוקר noun masculine singular absolute unspecified unspecified  	O	null
2 עת עת עת noun feminine singular construct unspecified unspecified  	O	null
3 יאור יאור יאור noun masculine singular absolute unspecified unspecified  	O	null
4 ו ו ואשוב conjunction unspecified unspecified unspecified unspecified unspecified 0 
4 אשוב נשב ואשוב verb masculine-and-feminine singular unspecified 1 future  	O	null
5 אשוב נשב אשוב verb masculine-and-feminine singular unspecified 1 future  	O	null
6 מלחום לחם מלחום verb unspecified unspecified unspecified unspecified infinitive  	O	null
7 , , , punctuation unspecified unspecified unspecified unspecified unspecified  	O	null
8 ה ה האמצא definiteArticle unspecified unspecified unspecified unspecified unspecified 0 
8 האמצא האמצא האמצא noun masculine singular absolute unspecified unspecified  	O	null
9 אמצא מצא אמצא verb masculine-and-feminine singular unspecified 1 future  	O	null
10 עדיין עדיין עדיין adverb unspecified unspecified unspecified unspecified unspecified  	O	null
11 זכר זכר זכר noun masculine singular construct unspecified unspecified  	O	null
12 זכר זכר זכר noun masculine singular absolute unspecified unspecified  	O	null
13 ל ל לחלום preposition unspecified unspecified unspecified unspecified unspecified 0 
13 ה ה לחלום definiteArticle unspecified unspecified unspecified unspecified unspecified 0 
13 החלום חלום לחלום noun masculine singular absolute unspecified unspecified  	O	null
14 ? ? ? punctuation unspecified unspecified unspecified unspecified unspecified  	O	null

0 שני שני שני noun masculine singular construct unspecified unspecified  	O	null
1 אורות אורות אורות properName unspecified unspecified unspecified unspecified unspecified  	I_ORG	null
2 בליל... בליל... בליל... properName unspecified unspecified unspecified unspecified unspecified  	I_ORG	null

