0 תקועה תקוע תקועה adjective feminine singular absolute unspecified unspecified  	O	null
1 ב ב בדרך preposition unspecified unspecified unspecified unspecified unspecified 0 
1 ה ה בדרך definiteArticle unspecified unspecified unspecified unspecified unspecified 0 
1 הדרך דרך בדרך noun feminine singular absolute unspecified unspecified  	O	null
2 , , , punctuation unspecified unspecified unspecified unspecified unspecified  	O	null
3 פסי פס פסי noun masculine plural construct unspecified unspecified  	O	null
4 רכבת רכבת רכבת noun feminine singular absolute unspecified unspecified  	O	null
5 כבר כבר כבר adverb unspecified unspecified unspecified unspecified unspecified  	O	null
6 לא לא לא negation unspecified unspecified unspecified unspecified unspecified  	O	null
7 זוכרת זכר זוכרת verb feminine singular unspecified any beinoni  	O	null
8 את את את at-preposition unspecified unspecified unspecified unspecified unspecified  	O	null
9 ה ה הפעם definiteArticle unspecified unspecified unspecified unspecified unspecified 0 
9 הפעם פעם הפעם noun feminine singular absolute unspecified unspecified  	O	null
10 ה ה האחרונה definiteArticle unspecified unspecified unspecified unspecified unspecified 0 
10 האחרונה אחרון האחרונה adjective feminine singular absolute unspecified unspecified  	O	null
11 מוקדם מוקדם מוקדם adverb unspecified unspecified unspecified unspecified unspecified  	O	null
12 סוגרת סגר סוגרת verb feminine singular unspecified any beinoni  	O	null
13 , , , punctuation unspecified unspecified unspecified unspecified unspecified  	O	null
14 טיפוס טיפוס טיפוס noun masculine singular absolute unspecified unspecified  	O	null
15 של של של shel-preposition unspecified unspecified unspecified unspecified unspecified  	O	null
16 ערב ערב ערב noun masculine singular absolute unspecified unspecified  	O	null
17 תמיד תמיד תמיד adverb unspecified unspecified unspecified unspecified unspecified  	O	null
18 חוזרת חזר חוזרת verb feminine singular unspecified any beinoni  	O	null
19 אל אל אל preposition unspecified unspecified unspecified unspecified unspecified  	O	null
20 את את אותה at-preposition unspecified unspecified unspecified unspecified unspecified  
20 ה ה אותה pronomial feminine singular unspecified 3 unspecified 0 	O	null
21 ה ה השכונה definiteArticle unspecified unspecified unspecified unspecified unspecified 0 
21 השכונה שכונה השכונה noun feminine singular absolute unspecified unspecified  	O	null
22 עיר עיר עיר noun feminine singular absolute unspecified unspecified  	O	null
23 של של של shel-preposition unspecified unspecified unspecified unspecified unspecified  	O	null
24 רחוב רחוב רחוב noun masculine singular absolute unspecified unspecified  	O	null
25 אחד CARD1 אחד numeral masculine singular absolute unspecified unspecified  	I_ORG	null
26 - - - punctuation unspecified unspecified unspecified unspecified unspecified  	I_ORG	null
27 הרצל הרצל הרצל properName unspecified unspecified unspecified unspecified unspecified  	I_PERS	null
28 בלובנד בלובנד בלובנד properName unspecified unspecified unspecified unspecified unspecified  	I_PERS	null
29 בתי בית בתי noun masculine plural construct unspecified unspecified  	B_ORG	null
30 ה ה הכלא definiteArticle unspecified unspecified unspecified unspecified unspecified 0 
30 הכלא כלא הכלא noun masculine singular absolute unspecified unspecified  	B_ORG	null
31 מלאים הלאה מלאים verb masculine plural unspecified any beinoni  	O	null
32 ב ב בטעויות preposition unspecified unspecified unspecified unspecified unspecified 0 
32 טעויות טעות בטעויות noun feminine plural absolute unspecified unspecified  	O	null
33 מ מ ממול preposition unspecified unspecified unspecified unspecified unspecified 0 
33 מול מול ממול noun masculine singular construct unspecified unspecified  	O	null
34 ה ה הנשר definiteArticle unspecified unspecified unspecified unspecified unspecified 0 
34 הנשר נשר הנשר noun masculine singular absolute unspecified unspecified  	O	null
35 , , , punctuation unspecified unspecified unspecified unspecified unspecified  	O	null
36 פורש פורש פורש verb masculine singular unspecified 3 past  	O	null
37 כנף כנף כנף noun feminine singular absolute unspecified unspecified  	O	null
38 מעל מעל מעל preposition unspecified unspecified unspecified unspecified unspecified  	O	null
39 עיר עיר עיר noun feminine singular construct unspecified unspecified  	O	null
40 ה ה האורות definiteArticle unspecified unspecified unspecified unspecified unspecified 0 
40 האורות אור האורות noun masculine plural absolute unspecified unspecified  	O	null
41 עיר עיר עיר noun feminine singular absolute unspecified unspecified  	O	null
42 של של של shel-preposition unspecified unspecified unspecified unspecified unspecified  	O	null
43 רחוב רחוב רחוב noun masculine singular absolute unspecified unspecified  	O	null
44 אחד CARD1 אחד numeral masculine singular absolute unspecified unspecified  	I_ORG	null
45 - - - punctuation unspecified unspecified unspecified unspecified unspecified  	I_ORG	null
46 הרצל הרצל הרצל properName unspecified unspecified unspecified unspecified unspecified  	I_PERS	null
47 בלובנד בלובנד בלובנד properName unspecified unspecified unspecified unspecified unspecified  	I_PERS	null
48 עיר עיר עיר noun feminine singular absolute unspecified unspecified  	O	null
49 מתפוררת התפורר מתפוררת verb feminine singular unspecified any beinoni  	O	null
50 . . . punctuation unspecified unspecified unspecified unspecified unspecified  	O	null

