0 טילפנתי טילפן טילפנתי verb masculine-and-feminine singular unspecified 1 past  	I_LOC	null
1 ל ל לאמריקה preposition unspecified unspecified unspecified unspecified unspecified 0 
1 אמריקה אמריקה לאמריקה properName unspecified unspecified unspecified unspecified unspecified  	I_LOC	null
2 לשמוע שמע לשמוע verb unspecified unspecified unspecified unspecified infinitive  	O	null
3 קצת קצת קצת adverb unspecified unspecified unspecified unspecified unspecified  	O	null
4 אנגלית אנגלית אנגלית properName feminine singular unspecified unspecified unspecified  	I_PERS	null
5 ענתה ענה ענתה verb feminine singular unspecified 3 past  	O	null
6 ל ל לי preposition unspecified unspecified unspecified unspecified unspecified  
6 י י לי pronomial masculine-and-feminine singular unspecified 1 unspecified 0 	O	null
7 מנומסת מנומס מנומסת adjective feminine singular absolute unspecified unspecified  	O	null
8 אחת CARD1 אחת numeral feminine singular absolute unspecified unspecified  	O	null
9 מרכזנית מרכזנית מרכזנית noun feminine plural absolute unspecified unspecified  	O	null
10 קולה קולה קולה noun feminine singular absolute unspecified unspecified  	O	null
11 ה ה המשגע definiteArticle unspecified unspecified unspecified unspecified unspecified 0 
11 המשגע שיגע המשגע participle masculine singular absolute any unspecified  	O	null
12 את את את at-preposition unspecified unspecified unspecified unspecified unspecified  	O	null
13 ליבי ליבי ליבי properName unspecified unspecified unspecified unspecified unspecified  	I_PERS	null
14 כבש כבש כבש verb masculine singular unspecified 3 past  	O	null
15 אמרתי אמר אמרתי verb masculine-and-feminine singular unspecified 1 past  	O	null
16 ל ל לה preposition unspecified unspecified unspecified unspecified unspecified  
16 ה ה לה pronomial feminine singular unspecified 3 unspecified 0 	O	null
17 ב ב ב.. preposition unspecified unspecified unspecified unspecified unspecified 0 
17 .. .. ב.. punctuation unspecified unspecified unspecified unspecified unspecified  	O	null
18 ב ב ב.. preposition unspecified unspecified unspecified unspecified unspecified 0 
18 .. .. ב.. punctuation unspecified unspecified unspecified unspecified unspecified  	O	null
19 קול קול קול noun masculine singular absolute unspecified unspecified  	O	null
20 נרגש נרגש נרגש adjective masculine singular absolute unspecified unspecified  	O	null
21 , , , punctuation unspecified unspecified unspecified unspecified unspecified  	O	null

0 גוביינא גוביינא גוביינא properName unspecified unspecified unspecified unspecified unspecified  	I_PERS	null
1 , , , punctuation unspecified unspecified unspecified unspecified unspecified  	O	null
2 גוביינא גוביינא גוביינא properName unspecified unspecified unspecified unspecified unspecified  	I_PERS	null
3 יקירתי יקירתי יקירתי adjective masculine singular absolute unspecified unspecified  	O	null
4 אני הוא אני pronoun masculine-and-feminine singular unspecified 1 unspecified  	O	null
5 לא לא לא negation unspecified unspecified unspecified unspecified unspecified  	O	null
6 אתן נתן אתן verb masculine-and-feminine singular unspecified 1 future  	O	null
7 ש ש שאת relativizer/subordinatingConjunction unspecified unspecified unspecified unspecified unspecified 0 
7 את את שאת at-preposition unspecified unspecified unspecified unspecified unspecified  	O	null
8 תנתקי תנתקי תנתקי properName unspecified unspecified unspecified unspecified unspecified  	I_PERS	null
9 . . . punctuation unspecified unspecified unspecified unspecified unspecified  	O	null

0 אני הוא אני pronoun masculine-and-feminine singular unspecified 1 unspecified  	O	null
1 כה כה כה adverb unspecified unspecified unspecified unspecified unspecified  	O	null
2 מאוהב מאוהב מאוהב adjective masculine singular absolute unspecified unspecified  	O	null
3 אל אל אל preposition unspecified unspecified unspecified unspecified unspecified  	O	null
4 תרדי תרד תרדי noun masculine plural construct unspecified unspecified  	O	null
5 ל ל לי preposition unspecified unspecified unspecified unspecified unspecified  
5 י י לי pronomial masculine-and-feminine singular unspecified 1 unspecified 0 	O	null
6 מ מ מהקו preposition unspecified unspecified unspecified unspecified unspecified 0 
6 ה ה מהקו definiteArticle unspecified unspecified unspecified unspecified unspecified 0 
6 הקו קו מהקו noun masculine singular absolute unspecified unspecified  	O	null
7 . . . punctuation unspecified unspecified unspecified unspecified unspecified  	O	null

0 גוביינא גוביינא גוביינא properName unspecified unspecified unspecified unspecified unspecified  	I_PERS	null
1    punctuation unspecified unspecified unspecified unspecified unspecified  	O	null
2 ני ני ני properName unspecified unspecified unspecified unspecified unspecified  	I_PERS	null
3 יודע ידע יודע verb masculine singular unspecified any beinoni  	O	null
4 שאת שאת שאת noun feminine singular absolute unspecified unspecified  	O	null
5 עסוקה עסוק עסוקה adjective feminine singular absolute unspecified unspecified  	O	null
6 , , , punctuation unspecified unspecified unspecified unspecified unspecified  	O	null
7 יושבת ישב יושבת verb feminine singular unspecified any beinoni  	O	null
8 שם שם שם adverb unspecified unspecified unspecified unspecified unspecified  	O	null
9 ב ב בדואר preposition unspecified unspecified unspecified unspecified unspecified 0 
9 ה ה בדואר definiteArticle unspecified unspecified unspecified unspecified unspecified 0 
9 הדואר דואר בדואר noun masculine singular absolute unspecified unspecified  	O	null
10 אצבעות אצבע אצבעות noun feminine plural absolute unspecified unspecified  	O	null
11 על על על preposition unspecified unspecified unspecified unspecified unspecified  	O	null
12 ה ה החוגה definiteArticle unspecified unspecified unspecified unspecified unspecified 0 
12 החוגה חוגה החוגה noun feminine singular absolute unspecified unspecified  	O	null
13 . . . punctuation unspecified unspecified unspecified unspecified unspecified  	O	null

0 אך אך אך conjunction unspecified unspecified unspecified unspecified unspecified  	O	null
1 תני תן תני noun masculine plural construct unspecified unspecified  	O	null
2 ל ל לי preposition unspecified unspecified unspecified unspecified unspecified  
2 י י לי pronomial masculine-and-feminine singular unspecified 1 unspecified 0 	O	null
3 לדבר דיבר לדבר verb unspecified unspecified unspecified unspecified infinitive  	O	null
4 את את איתך at-preposition unspecified unspecified unspecified unspecified unspecified  
4 ך ך איתך pronomial masculine singular unspecified 2 unspecified 0 	O	null
5 כמה כמה כמה quantifier unspecified unspecified construct unspecified unspecified  	O	null
6 מילים מילה מילים noun feminine plural absolute unspecified unspecified  	O	null
7 , , , punctuation unspecified unspecified unspecified unspecified unspecified  	O	null
8 הוצאת הוצאה הוצאת noun feminine singular construct unspecified unspecified  	O	null
9 את את אותי at-preposition unspecified unspecified unspecified unspecified unspecified  
9 י י אותי pronomial masculine-and-feminine singular unspecified 1 unspecified 0 	O	null
10 מ מ מהכלים preposition unspecified unspecified unspecified unspecified unspecified 0 
10 ה ה מהכלים definiteArticle unspecified unspecified unspecified unspecified unspecified 0 
10 הכלים כלי מהכלים noun masculine plural absolute unspecified unspecified  	O	null
11 . . . punctuation unspecified unspecified unspecified unspecified unspecified  	O	null

0 גוביינא גוביינא גוביינא properName unspecified unspecified unspecified unspecified unspecified  	I_PERS	null
1 , , , punctuation unspecified unspecified unspecified unspecified unspecified  	O	null
2 גוביינא גוביינא גוביינא properName unspecified unspecified unspecified unspecified unspecified  	I_PERS	null
3 יקירתי... יקירתי... יקירתי... properName unspecified unspecified unspecified unspecified unspecified  	I_PERS	null

0 גוביינא גוביינא גוביינא properName unspecified unspecified unspecified unspecified unspecified  	I_ORG	null
1 רק רק רק conjunction unspecified unspecified unspecified unspecified unspecified  	O	null
2 לראות ראה לראות verb unspecified unspecified unspecified unspecified infinitive  	O	null
3 את את אותך at-preposition unspecified unspecified unspecified unspecified unspecified  
3 ך ך אותך pronomial masculine singular unspecified 2 unspecified 0 	O	null
4 אני הוא אני pronoun masculine-and-feminine singular unspecified 1 unspecified  	O	null
5 מוכן הוכן מוכן verb masculine singular unspecified any beinoni  	O	null
6 , , , punctuation unspecified unspecified unspecified unspecified unspecified  	O	null
7 אמשוך משך אמשוך verb masculine-and-feminine singular unspecified 1 future  	O	null
8 ב ב בחוט preposition unspecified unspecified unspecified unspecified unspecified 0 
8 חוט חוט בחוט noun masculine singular construct unspecified unspecified  	O	null
9 ה ה הטלפון definiteArticle unspecified unspecified unspecified unspecified unspecified 0 
9 הטלפון טלפון הטלפון noun masculine singular absolute unspecified unspecified  	O	null
10 , , , punctuation unspecified unspecified unspecified unspecified unspecified  	O	null
11 אביא הביא אביא verb masculine-and-feminine singular unspecified 1 future  	O	null
12 את את אותך at-preposition unspecified unspecified unspecified unspecified unspecified  
12 ך ך אותך pronomial masculine singular unspecified 2 unspecified 0 	O	null
13 לכאן לכאן לכאן adverb unspecified unspecified unspecified unspecified unspecified  	I_LOC	null
14 . . . punctuation unspecified unspecified unspecified unspecified unspecified  	O	null

0 את את את at-preposition unspecified unspecified unspecified unspecified unspecified  	O	null
1 בחורה בחור בחורה noun feminine singular absolute unspecified unspecified  	O	null
2 מושכת מושך מושכת adjective feminine singular absolute unspecified unspecified  	O	null
3 , , , punctuation unspecified unspecified unspecified unspecified unspecified  	O	null
4 יש יש יש existential unspecified unspecified unspecified unspecified unspecified  	O	null
5 ל ל לי preposition unspecified unspecified unspecified unspecified unspecified  
5 י י לי pronomial masculine-and-feminine singular unspecified 1 unspecified 0 	O	null
6 הוכחות הוכחה הוכחות noun feminine plural absolute unspecified unspecified  	O	null
7 תמיד תמיד תמיד adverb unspecified unspecified unspecified unspecified unspecified  	O	null
8 אצל אצל אצלך preposition unspecified unspecified unspecified unspecified unspecified  
8 ך ך אצלך pronomial masculine singular unspecified 2 unspecified 0 	O	null
9 העמדות העמדה העמדות noun feminine plural absolute unspecified unspecified  	O	null
10 תפוסות תפוסה תפוסות noun feminine plural absolute unspecified unspecified  	O	null
11 . . . punctuation unspecified unspecified unspecified unspecified unspecified  	O	null

0 גוביינא גוביינא גוביינא properName unspecified unspecified unspecified unspecified unspecified  	I_PERS	null
1 , , , punctuation unspecified unspecified unspecified unspecified unspecified  	O	null
2 גוביינא גוביינא גוביינא properName unspecified unspecified unspecified unspecified unspecified  	I_PERS	null
3 יקירתי... יקירתי... יקירתי... properName unspecified unspecified unspecified unspecified unspecified  	I_PERS	null

0 ללא ללא ללא preposition unspecified unspecified unspecified unspecified unspecified  	O	null
1 ירח ירח ירח noun masculine singular construct unspecified unspecified  	O	null
2 מעל מעל מעל noun masculine singular absolute unspecified unspecified  	O	null
3 , , , punctuation unspecified unspecified unspecified unspecified unspecified  	O	null
4 שלכת שלכת שלכת noun feminine singular absolute unspecified unspecified  	O	null
5 או או או conjunction unspecified unspecified unspecified unspecified unspecified  	O	null
6 ספסל ספסל ספסל noun masculine singular absolute unspecified unspecified  	O	null
7 אני הוא אני pronoun masculine-and-feminine singular unspecified 1 unspecified  	O	null
8 בא בא בא verb masculine singular unspecified any beinoni  	O	null
9 אל אל אלייך preposition unspecified unspecified unspecified unspecified unspecified  
9 ך ך אלייך pronomial feminine singular unspecified 2 unspecified 0 	O	null
10 ב ב בחיוג preposition unspecified unspecified unspecified unspecified unspecified 0 
10 חיוג חיוג בחיוג noun masculine singular absolute unspecified unspecified  	O	null
11 ישיר ישיר ישיר adjective masculine singular absolute unspecified unspecified  	O	null
12 . . . punctuation unspecified unspecified unspecified unspecified unspecified  	O	null

0 שנינו שנה שנינו verb masculine-and-feminine plural unspecified 1 past  	O	null
1 נפרום פרם נפרום verb masculine-and-feminine plural unspecified 1 future  	O	null
2 את את את at-preposition unspecified unspecified unspecified unspecified unspecified  	O	null
3 חוט חוט חוט noun masculine singular construct unspecified unspecified  	O	null
4 ה ה הטלפון definiteArticle unspecified unspecified unspecified unspecified unspecified 0 
4 הטלפון טלפון הטלפון noun masculine singular absolute unspecified unspecified  	O	null
5 , , , punctuation unspecified unspecified unspecified unspecified unspecified  	O	null
6 מ מ מכל preposition unspecified unspecified unspecified unspecified unspecified 0 
6 כל כול מכל quantifier unspecified unspecified construct unspecified unspecified  	O	null
7 ה ה הדיבורים definiteArticle unspecified unspecified unspecified unspecified unspecified 0 
7 הדיבורים דיבור הדיבורים noun masculine plural absolute unspecified unspecified  	O	null
8 אולי אולי אולי adverb unspecified unspecified unspecified unspecified unspecified  	O	null
9 בסוף בסוף בסוף adverb unspecified unspecified unspecified unspecified unspecified  	O	null
10 נכיר הכיר נכיר verb masculine-and-feminine plural unspecified 1 future  	O	null
11 . . . punctuation unspecified unspecified unspecified unspecified unspecified  	O	null

0 יבוא בא יבוא verb masculine singular unspecified 3 future  	O	null
1 היום היום היום adverb unspecified unspecified unspecified unspecified unspecified  	O	null
2 גוביינא גוביינא גוביינא properName unspecified unspecified unspecified unspecified unspecified  	I_LOC	null
3 ו ו ועוד conjunction unspecified unspecified unspecified unspecified unspecified 0 
3 עוד עוד ועוד adverb unspecified unspecified unspecified unspecified unspecified  	O	null
4 ניפגש נפגש ניפגש verb masculine singular unspecified 3 past  	O	null
5 , , , punctuation unspecified unspecified unspecified unspecified unspecified  	I_LOC	null
6 פנמה פנמה פנמה properName unspecified unspecified unspecified unspecified unspecified  	I_LOC	null
7 או או או conjunction unspecified unspecified unspecified unspecified unspecified  	O	null
8 קנדה קנדה קנדה properName unspecified unspecified unspecified unspecified unspecified  	I_LOC	null
9 , , , punctuation unspecified unspecified unspecified unspecified unspecified  	O	null
10 ספרד ספרד ספרד properName unspecified unspecified unspecified unspecified unspecified  	I_LOC	null
11 או או או conjunction unspecified unspecified unspecified unspecified unspecified  	O	null
12 ב ב בחמש preposition unspecified unspecified unspecified unspecified unspecified 0 
12 חמש CARD5 בחמש numeral feminine singular absolute unspecified unspecified  	O	null
13 . . . punctuation unspecified unspecified unspecified unspecified unspecified  	O	null

0 אזמין הזמין אזמין verb masculine-and-feminine singular unspecified 1 future  	O	null
1 את את אותך at-preposition unspecified unspecified unspecified unspecified unspecified  
1 ך ך אותך pronomial masculine singular unspecified 2 unspecified 0 	O	null
2 ל ל לחדר preposition unspecified unspecified unspecified unspecified unspecified 0 
2 חדר חדר לחדר noun masculine singular absolute unspecified unspecified  	O	null
3 ב ב במלון preposition unspecified unspecified unspecified unspecified unspecified 0 
3 מלון מלון במלון noun masculine singular construct unspecified unspecified  	O	null
4 פאר פאר פאר properName unspecified unspecified unspecified unspecified unspecified  	I_PERS	null
5 נרים הרים נרים verb masculine-and-feminine plural unspecified 1 future  	O	null
6 ה ה הטלפון definiteArticle unspecified unspecified unspecified unspecified unspecified 0 
6 הטלפון טלפון הטלפון noun masculine singular absolute unspecified unspecified  	O	null
7 ו ו ונדבר conjunction unspecified unspecified unspecified unspecified unspecified 0 
7 נדבר נדבר ונדבר verb masculine singular unspecified 3 past  	O	null
8 . . . punctuation unspecified unspecified unspecified unspecified unspecified  	O	null

0 גוביינא גוביינא גוביינא properName unspecified unspecified unspecified unspecified unspecified  	I_PERS	null
1 , , , punctuation unspecified unspecified unspecified unspecified unspecified  	O	null
2 גוביינא גוביינא גוביינא properName unspecified unspecified unspecified unspecified unspecified  	I_PERS	null
3 יקירתי... יקירתי... יקירתי... properName unspecified unspecified unspecified unspecified unspecified  	I_PERS	null

