0 מספרים מספר מספרים noun masculine plural absolute unspecified unspecified  	O	null
1 על על על preposition unspecified unspecified unspecified unspecified unspecified  	O	null
2 ציפי ציפי ציפי properName unspecified unspecified unspecified unspecified unspecified  	I_PERS	null
3 פרימו פרימו פרימו properName unspecified unspecified unspecified unspecified unspecified  	I_PERS	null
4 מ מ מחולון preposition unspecified unspecified unspecified unspecified unspecified 0 
4 חולון חולון מחולון properName unspecified unspecified unspecified unspecified unspecified  	I_LOC	null
5 , , , punctuation unspecified unspecified unspecified unspecified unspecified  	O	null
6 לון לן לון verb masculine singular unspecified 2 imperative  	O	null
7 , , , punctuation unspecified unspecified unspecified unspecified unspecified  	O	null
8 לון לן לון verb masculine singular unspecified 2 imperative  	O	null
9 . . . punctuation unspecified unspecified unspecified unspecified unspecified  	O	null

0 ש ש שנמאס relativizer/subordinatingConjunction unspecified unspecified unspecified unspecified unspecified 0 
0 נמאס נמאס שנמאס verb masculine singular unspecified 3 past  	O	null
1 ל ל לה preposition unspecified unspecified unspecified unspecified unspecified  
1 ה ה לה pronomial feminine singular unspecified 3 unspecified 0 	O	null
2 מ מ מלקום preposition unspecified unspecified unspecified unspecified unspecified 0 
2 לקום קם מלקום verb unspecified unspecified unspecified unspecified infinitive  	O	null
3 ו ו ולשבת conjunction unspecified unspecified unspecified unspecified unspecified 0 
3 לשבת ישב ולשבת verb unspecified unspecified unspecified unspecified infinitive  	O	null
4 . . . punctuation unspecified unspecified unspecified unspecified unspecified  	O	null

0 עד עד עד preposition unspecified unspecified unspecified unspecified unspecified  	O	null
1 ש ש שיום relativizer/subordinatingConjunction unspecified unspecified unspecified unspecified unspecified 0 
1 יום יום שיום noun masculine singular absolute unspecified unspecified  	O	null
2 אחד CARD1 אחד numeral masculine singular absolute unspecified unspecified  	O	null
3 עלתה עלה עלתה verb feminine singular unspecified 3 past  	O	null
4 היא הוא היא copula feminine singular unspecified 3 beinoni  	O	null
5 על על על preposition unspecified unspecified unspecified unspecified unspecified  	O	null
6 סילון סילון סילון noun masculine singular absolute unspecified unspecified  	O	null
7 , , , punctuation unspecified unspecified unspecified unspecified unspecified  	O	null
8 לון לן לון verb masculine singular unspecified 2 imperative  	O	null
9 , , , punctuation unspecified unspecified unspecified unspecified unspecified  	O	null
10 לון לן לון verb masculine singular unspecified 2 imperative  	O	null
11 ו ו והיא conjunction unspecified unspecified unspecified unspecified unspecified 0 
11 היא הוא והיא pronoun feminine singular unspecified 3 unspecified  	O	null
12 טסה טס טסה verb feminine singular unspecified 3 past  	O	null
13 ל ל ליבשת preposition unspecified unspecified unspecified unspecified unspecified 0 
13 ה ה ליבשת definiteArticle unspecified unspecified unspecified unspecified unspecified 0 
13 היבשת יבשת ליבשת noun feminine singular absolute unspecified unspecified  	O	null
14 ה ה המוזהבת definiteArticle unspecified unspecified unspecified unspecified unspecified 0 
14 המוזהבת מוזהב המוזהבת adjective feminine singular absolute unspecified unspecified  	O	null
15 . . . punctuation unspecified unspecified unspecified unspecified unspecified  	O	null

0 עזבה עזב עזבה verb feminine singular unspecified 3 past  	O	null
1 את את את at-preposition unspecified unspecified unspecified unspecified unspecified  	O	null
2 ה ה האמא definiteArticle unspecified unspecified unspecified unspecified unspecified 0 
2 האמא אמא האמא noun feminine singular absolute unspecified unspecified  	O	null
3 ו ו והמשפחה conjunction unspecified unspecified unspecified unspecified unspecified 0 
3 ה ה והמשפחה definiteArticle unspecified unspecified unspecified unspecified unspecified 0 
3 המשפחה משפחה והמשפחה noun feminine singular absolute unspecified unspecified  	O	null
4 , , , punctuation unspecified unspecified unspecified unspecified unspecified  	O	null
5 עזבה עזב עזבה verb feminine singular unspecified 3 past  	O	null
6 את את את at-preposition unspecified unspecified unspecified unspecified unspecified  	O	null
7 ה ה הבית definiteArticle unspecified unspecified unspecified unspecified unspecified 0 
7 הבית בית הבית noun masculine singular absolute unspecified unspecified  	O	null
8 ו ו והמלתחה conjunction unspecified unspecified unspecified unspecified unspecified 0 
8 ה ה והמלתחה definiteArticle unspecified unspecified unspecified unspecified unspecified 0 
8 המלתחה מלתחה והמלתחה noun feminine singular absolute unspecified unspecified  	O	null
9 , , , punctuation unspecified unspecified unspecified unspecified unspecified  	O	null
10 נסעה נסע נסעה verb feminine singular unspecified 3 past  	O	null
11 ל ל לקליפורניה preposition unspecified unspecified unspecified unspecified unspecified 0 
11 קליפורניה קליפורניה לקליפורניה properName unspecified unspecified unspecified unspecified unspecified  	I_LOC	null
12 , , , punctuation unspecified unspecified unspecified unspecified unspecified  	O	null
13 גרה גירה גרה verb masculine singular unspecified 3 past  	O	null
14 שם שם שם adverb unspecified unspecified unspecified unspecified unspecified  	O	null
15 עם עם עם preposition unspecified unspecified unspecified unspecified unspecified  	O	null
16 סוניה סוניה סוניה properName unspecified unspecified unspecified unspecified unspecified  	I_PERS	null
17 יחד יחד יחד adverb unspecified unspecified unspecified unspecified unspecified  	O	null
18 ב ב בדירה preposition unspecified unspecified unspecified unspecified unspecified 0 
18 דירה דירה בדירה noun feminine singular absolute unspecified unspecified  	O	null
19 שכורה שכור שכורה adjective feminine singular absolute unspecified unspecified  	O	null
20 . . . punctuation unspecified unspecified unspecified unspecified unspecified  	O	null

0 עשתה עשה עשתה verb feminine singular unspecified 3 past  	O	null
1 הרבה הרבה הרבה quantifier unspecified unspecified construct unspecified unspecified  	O	null
2 עיניים עין עיניים noun feminine plural absolute unspecified unspecified  	O	null
3 אך אך אך conjunction unspecified unspecified unspecified unspecified unspecified  	O	null
4 בינתיים בינתיים בינתיים adverb unspecified unspecified unspecified unspecified unspecified  	O	null
5 שום שום שום quantifier unspecified unspecified construct unspecified unspecified  	O	null
6 דבר דבר דבר noun masculine singular absolute unspecified unspecified  	O	null
7 עוד עוד עוד adverb unspecified unspecified unspecified unspecified unspecified  	O	null
8 לא לא לא negation unspecified unspecified unspecified unspecified unspecified  	O	null
9 קרה קרה קרה verb masculine singular unspecified 3 past  	O	null
10 . . . punctuation unspecified unspecified unspecified unspecified unspecified  	O	null

0 ה ה הימים definiteArticle unspecified unspecified unspecified unspecified unspecified 0 
0 הימים יום הימים noun masculine plural absolute unspecified unspecified  	O	null
1 חלפו חלף חלפו verb masculine-and-feminine plural unspecified 3 past  	O	null
2 לאט לאט לאט adverb unspecified unspecified unspecified unspecified unspecified  	O	null
3 כמו כמו כמו preposition unspecified unspecified unspecified unspecified unspecified  	O	null
4 שעון שעון שעון noun masculine singular absolute unspecified unspecified  	O	null
5 , , , punctuation unspecified unspecified unspecified unspecified unspecified  	O	null
6 עון עון עון properName unspecified unspecified unspecified unspecified unspecified  	I_PERS	null
7 , , , punctuation unspecified unspecified unspecified unspecified unspecified  	O	null
8 עון עון עון properName unspecified unspecified unspecified unspecified unspecified  	I_PERS	null
9 . . . punctuation unspecified unspecified unspecified unspecified unspecified  	O	null

0 לא לא לא negation unspecified unspecified unspecified unspecified unspecified  	O	null
1 חיכה חיכה חיכה verb masculine singular unspecified 3 past  	O	null
2 ל ל לה preposition unspecified unspecified unspecified unspecified unspecified  
2 ה ה לה pronomial feminine singular unspecified 3 unspecified 0 	O	null
3 שום שום שום quantifier unspecified unspecified construct unspecified unspecified  	O	null
4 משיח משיח משיח noun masculine singular absolute unspecified unspecified  	O	null
5 ב ב באופק preposition unspecified unspecified unspecified unspecified unspecified 0 
5 אופק אופק באופק noun masculine singular absolute unspecified unspecified  	O	null
6 . . . punctuation unspecified unspecified unspecified unspecified unspecified  	O	null

0 עד עד עד preposition unspecified unspecified unspecified unspecified unspecified  	O	null
1 ש ש שיום relativizer/subordinatingConjunction unspecified unspecified unspecified unspecified unspecified 0 
1 יום יום שיום noun masculine singular absolute unspecified unspecified  	O	null
2 אחד CARD1 אחד numeral masculine singular absolute unspecified unspecified  	O	null
3 פגשה פגש פגשה verb feminine singular unspecified 3 past  	O	null
4 היא הוא היא pronoun feminine singular unspecified 3 unspecified  	O	null
5 ב ב בחורון preposition unspecified unspecified unspecified unspecified unspecified 0 
5 חורון חורון בחורון properName unspecified unspecified unspecified unspecified unspecified  	I_LOC	null
6 , , , punctuation unspecified unspecified unspecified unspecified unspecified  	O	null
7 רון רון רון properName unspecified unspecified unspecified unspecified unspecified  	I_PERS	null
8 , , , punctuation unspecified unspecified unspecified unspecified unspecified  	O	null
9 רון רון רון properName unspecified unspecified unspecified unspecified unspecified  	I_PERS	null
10 . . . punctuation unspecified unspecified unspecified unspecified unspecified  	O	null

0 איטלקי איטלקי איטלקי adjective masculine singular absolute unspecified unspecified  	O	null
1 ש ש שקצת relativizer/subordinatingConjunction unspecified unspecified unspecified unspecified unspecified 0 
1 קצת קצת שקצת adverb unspecified unspecified unspecified unspecified unspecified  	O	null
2 הקפיץ הקפיץ הקפיץ verb masculine singular unspecified 3 past  	O	null
3 ל ל לה preposition unspecified unspecified unspecified unspecified unspecified  
3 ה ה לה pronomial feminine singular unspecified 3 unspecified 0 	O	null
4 את את את at-preposition unspecified unspecified unspecified unspecified unspecified  	O	null
5 ה ה הדופק definiteArticle unspecified unspecified unspecified unspecified unspecified 0 
5 הדופק דופק הדופק noun masculine singular absolute unspecified unspecified  	O	null
6 . . . punctuation unspecified unspecified unspecified unspecified unspecified  	O	null

0 עזבה עזב עזבה verb feminine singular unspecified 3 past  	O	null
1 את את את at-preposition unspecified unspecified unspecified unspecified unspecified  	O	null
2 סוניה סוניה סוניה properName unspecified unspecified unspecified unspecified unspecified  	I_PERS	null
3 ו ו ואת conjunction unspecified unspecified unspecified unspecified unspecified 0 
3 את את ואת at-preposition unspecified unspecified unspecified unspecified unspecified  	O	null
4 ה ה הדירה definiteArticle unspecified unspecified unspecified unspecified unspecified 0 
4 הדירה דירה הדירה noun feminine singular absolute unspecified unspecified  	O	null
5 עזבה עזב עזבה verb feminine singular unspecified 3 past  	O	null
6 משענת משענת משענת noun feminine singular absolute unspecified unspecified  	O	null
7 ו ו וחברה conjunction unspecified unspecified unspecified unspecified unspecified 0 
7 חברה חבר וחברה noun feminine singular absolute unspecified unspecified  	O	null
8 עברה עבר עברה verb feminine singular unspecified 3 past  	O	null
9 לגור גר לגור verb unspecified unspecified unspecified unspecified infinitive  	O	null
10 עם עם עם preposition unspecified unspecified unspecified unspecified unspecified  	O	null
11 טוני טוני טוני properName unspecified unspecified unspecified unspecified unspecified  	I_PERS	null
12 , , , punctuation unspecified unspecified unspecified unspecified unspecified  	O	null
13 בישלה בישל בישלה verb feminine singular unspecified 3 past  	O	null
14 ל ל לו preposition unspecified unspecified unspecified unspecified unspecified  
14 ו ו לו pronomial masculine singular unspecified 3 unspecified 0 	O	null
15 קנלוני קנלוני קנלוני noun masculine singular absolute unspecified unspecified  	O	null
16 , , , punctuation unspecified unspecified unspecified unspecified unspecified  	O	null
17 הם הוא הם pronoun masculine plural unspecified 3 unspecified  	O	null
18 חיו חי חיו verb masculine-and-feminine plural unspecified 3 past  	O	null
19 ב ב בסגנון preposition unspecified unspecified unspecified unspecified unspecified 0 
19 סגנון סגנון בסגנון noun masculine singular absolute unspecified unspecified  	O	null
20 מסור מסור מסור adjective masculine singular absolute unspecified unspecified  	O	null
21 . . . punctuation unspecified unspecified unspecified unspecified unspecified  	O	null

0 ו ו ויום conjunction unspecified unspecified unspecified unspecified unspecified 0 
0 יום יום ויום noun masculine singular absolute unspecified unspecified  	O	null
1 אחד CARD1 אחד numeral masculine singular absolute unspecified unspecified  	O	null
2 היא הוא היא pronoun feminine singular unspecified 3 unspecified  	O	null
3 קמה קם קמה verb feminine singular unspecified 3 past  	O	null
4 , , , punctuation unspecified unspecified unspecified unspecified unspecified  	O	null
5 ו ו ורק conjunction unspecified unspecified unspecified unspecified unspecified 0 
5 רק רק ורק conjunction unspecified unspecified unspecified unspecified unspecified  	O	null
6 פיג'מה פיג'מה פיג'מה noun feminine singular absolute unspecified unspecified  	O	null
7 נשארה נשאר נשארה verb feminine singular unspecified 3 past  	O	null
8 מ מ מהבחור preposition unspecified unspecified unspecified unspecified unspecified 0 
8 ה ה מהבחור definiteArticle unspecified unspecified unspecified unspecified unspecified 0 
8 הבחור בחור מהבחור noun masculine singular absolute unspecified unspecified  	O	null
9 . . . punctuation unspecified unspecified unspecified unspecified unspecified  	O	null

0 אל אל אל preposition unspecified unspecified unspecified unspecified unspecified  	O	null
1 ה ה הרחובות definiteArticle unspecified unspecified unspecified unspecified unspecified 0 
1 הרחובות רחוב הרחובות noun masculine plural absolute unspecified unspecified  	O	null
2 יצאה יצא יצאה verb feminine singular unspecified 3 past  	O	null
3 , , , punctuation unspecified unspecified unspecified unspecified unspecified  	O	null
4 מטלטלת טלטל מטלטלת verb feminine singular unspecified any beinoni  	O	null
5 מזוודה מזוודה מזוודה noun feminine singular absolute unspecified unspecified  	O	null
6 . . . punctuation unspecified unspecified unspecified unspecified unspecified  	O	null

0 היא הוא היא pronoun feminine singular unspecified 3 unspecified  	O	null
1 היתה הוא היתה copula feminine singular unspecified 3 past  	O	null
2 רק רק רק conjunction unspecified unspecified unspecified unspecified unspecified  	O	null
3 בת בת בת noun feminine singular construct unspecified unspecified  	O	null
4 עשרים ORD-CARD20 עשרים numeral masculine-and-feminine plural construct unspecified unspecified  	O	null
5 ו ו וכבר conjunction unspecified unspecified unspecified unspecified unspecified 0 
5 כבר כבר וכבר adverb unspecified unspecified unspecified unspecified unspecified  	O	null
6 בלויה בלוי בלויה adjective feminine singular absolute unspecified unspecified  	O	null
7 . . . punctuation unspecified unspecified unspecified unspecified unspecified  	O	null

0 חזרה חזרה חזרה noun feminine singular absolute unspecified unspecified  	O	null
1 אל אל אל preposition unspecified unspecified unspecified unspecified unspecified  	O	null
2 סוניה סוניה סוניה properName unspecified unspecified unspecified unspecified unspecified  	I_PERS	null
3 ו ו ואל conjunction unspecified unspecified unspecified unspecified unspecified 0 
3 אל אל ואל preposition unspecified unspecified unspecified unspecified unspecified  	O	null
4 ה ה הדירה definiteArticle unspecified unspecified unspecified unspecified unspecified 0 
4 הדירה דירה הדירה noun feminine singular absolute unspecified unspecified  	O	null
5 , , , punctuation unspecified unspecified unspecified unspecified unspecified  	O	null
6 חזרה חזר חזרה verb feminine singular unspecified 3 past  	O	null
7 אל אל אל preposition unspecified unspecified unspecified unspecified unspecified  	O	null
8 ה ה האמא definiteArticle unspecified unspecified unspecified unspecified unspecified 0 
8 האמא אמא האמא noun feminine singular absolute unspecified unspecified  	O	null
9 ו ו והמשפחה conjunction unspecified unspecified unspecified unspecified unspecified 0 
9 ה ה והמשפחה definiteArticle unspecified unspecified unspecified unspecified unspecified 0 
9 המשפחה משפחה והמשפחה noun feminine singular absolute unspecified unspecified  	O	null
10 . . . punctuation unspecified unspecified unspecified unspecified unspecified  	O	null

0 עכשיו עכשיו עכשיו adverb unspecified unspecified unspecified unspecified unspecified  	O	null
1 היא הוא היא pronoun feminine singular unspecified 3 unspecified  	O	null
2 מסתובבת הסתובב מסתובבת verb feminine singular unspecified any beinoni  	O	null
3 ב ב בחולון preposition unspecified unspecified unspecified unspecified unspecified 0 
3 חולון חולון בחולון properName unspecified unspecified unspecified unspecified unspecified  	I_LOC	null
4 עובדת עבד עובדת properName unspecified unspecified unspecified unspecified unspecified  	I_PERS	null
5 , , , punctuation unspecified unspecified unspecified unspecified unspecified  	I_LOC	null
6 צומת צומת צומת noun feminine singular construct unspecified unspecified  	I_LOC	null
7 פה פה פה noun masculine singular absolute unspecified unspecified  	I_LOC	null
8 ו ו וצומת conjunction unspecified unspecified unspecified unspecified unspecified 0 
8 צומת צומת וצומת noun feminine singular construct unspecified unspecified  	I_LOC	null
9 שם שם שם noun masculine singular absolute unspecified unspecified  	I_LOC	null
10 . . . punctuation unspecified unspecified unspecified unspecified unspecified  	O	null

0 לחבר'ה לחבר'ה לחבר'ה properName unspecified unspecified unspecified unspecified unspecified  	I_PERS	null
1 מספרת סיפר מספרת verb feminine singular unspecified any beinoni  	O	null
2 , , , punctuation unspecified unspecified unspecified unspecified unspecified  	O	null
3 מתארת תיאר מתארת verb feminine singular unspecified any beinoni  	O	null
4 , , , punctuation unspecified unspecified unspecified unspecified unspecified  	O	null
5 איך איך איך adverb unspecified unspecified unspecified unspecified unspecified  	O	null
6 כבשה כבש כבשה verb feminine singular unspecified 3 past  	O	null
7 את את את at-preposition unspecified unspecified unspecified unspecified unspecified  	O	null
8 ה ה העולם definiteArticle unspecified unspecified unspecified unspecified unspecified 0 
8 העולם עולם העולם noun masculine singular absolute unspecified unspecified  	O	null
9 . . . punctuation unspecified unspecified unspecified unspecified unspecified  	O	null

