0 כנרת כנרת כנרת properName unspecified unspecified unspecified unspecified unspecified  	I_PERS	null
1 , , , punctuation unspecified unspecified unspecified unspecified unspecified  	O	null
2 כנרת כנרת כנרת properName unspecified unspecified unspecified unspecified unspecified  	I_PERS	null
3 , , , punctuation unspecified unspecified unspecified unspecified unspecified  	O	null
4 אל אל אליך preposition unspecified unspecified unspecified unspecified unspecified  
4 ך ך אליך pronomial masculine singular unspecified 2 unspecified 0 	O	null
5 נמשכת נמשך נמשכת verb feminine singular unspecified any beinoni  	O	null
6 כל כול כל quantifier unspecified unspecified construct unspecified unspecified  	O	null
7 נפש נפש נפש noun feminine singular absolute unspecified unspecified  	O	null
8 מאז מאז מאז adverb unspecified unspecified unspecified unspecified unspecified  	I_LOC	null
9 . . . punctuation unspecified unspecified unspecified unspecified unspecified  	O	null

0 כל כול כל quantifier unspecified unspecified construct unspecified unspecified  	O	null
1 קסם קסם קסם noun masculine singular absolute unspecified unspecified  	O	null
2 מולדת מולדת מולדת noun feminine singular absolute unspecified unspecified  	O	null
3 מ מ מימיך preposition unspecified unspecified unspecified unspecified unspecified 0 
3 ימי יום מימיך noun masculine plural absolute unspecified unspecified  
3 ך ך מימיך possessive feminine singular unspecified 2 unspecified 0 	O	null
4 יפיקו הפיק יפיקו verb masculine-and-feminine plural unspecified 3 future  	O	null
5 ב ב בלילה preposition unspecified unspecified unspecified unspecified unspecified 0 
5 ה ה בלילה definiteArticle unspecified unspecified unspecified unspecified unspecified 0 
5 הלילה לילה בלילה noun masculine singular absolute unspecified unspecified  	O	null
6 כ כ כרז preposition unspecified unspecified unspecified unspecified unspecified 0 
6 רז רז כרז properName unspecified unspecified unspecified unspecified unspecified  	I_PERS	null
7 , , , punctuation unspecified unspecified unspecified unspecified unspecified  	O	null
8 סודות סוד סודות noun masculine plural construct unspecified unspecified  	O	null
9 ה ה הימים definiteArticle unspecified unspecified unspecified unspecified unspecified 0 
9 הימים יום הימים noun masculine plural absolute unspecified unspecified  	O	null
10 שנגוזו שנגוזו שנגוזו verb masculine-and-feminine plural unspecified 3 future  	O	null
11 ב ב ברטט preposition unspecified unspecified unspecified unspecified unspecified 0 
11 רטט רטט ברטט noun masculine singular construct unspecified unspecified  	O	null
12 ה ה הגל definiteArticle unspecified unspecified unspecified unspecified unspecified 0 
12 הגל גל הגל noun masculine singular absolute unspecified unspecified  	O	null
13 ה ה השלו definiteArticle unspecified unspecified unspecified unspecified unspecified 0 
13 השלו שלו השלו adjective masculine singular absolute unspecified unspecified  	O	null
14 - - - punctuation unspecified unspecified unspecified unspecified unspecified  	O	null
15 ו ו ולך conjunction unspecified unspecified unspecified unspecified unspecified 0 
15 לך הלך ולך verb masculine singular unspecified 2 imperative  	O	null
16 כל כול כל quantifier unspecified unspecified construct unspecified unspecified  	O	null
17 בני בן בניך noun masculine plural absolute unspecified unspecified  
17 ך ך בניך possessive feminine singular unspecified 2 unspecified 0 	O	null
18 יחרזו חרז יחרזו verb masculine-and-feminine plural unspecified 3 future  	O	null
19 מיטב מיטב מיטב noun masculine singular construct unspecified unspecified  	O	null
20 מנגינות מנגינה מנגינות noun feminine plural absolute unspecified unspecified  	O	null
21 ש ש שבלב relativizer/subordinatingConjunction unspecified unspecified unspecified unspecified unspecified 0 
21 ב ב שבלב preposition unspecified unspecified unspecified unspecified unspecified 0 
21 ה ה שבלב definiteArticle unspecified unspecified unspecified unspecified unspecified 0 
21 הלב לב שבלב noun masculine singular absolute unspecified unspecified  	O	null
22 . . . punctuation unspecified unspecified unspecified unspecified unspecified  	O	null

0 כנרת כנרת כנרת properName unspecified unspecified unspecified unspecified unspecified  	I_PERS	null
1 , , , punctuation unspecified unspecified unspecified unspecified unspecified  	O	null
2 כנרת כנרת כנרת properName unspecified unspecified unspecified unspecified unspecified  	I_PERS	null
3 , , , punctuation unspecified unspecified unspecified unspecified unspecified  	O	null
4 כנרת כנרת כנרת properName unspecified unspecified unspecified unspecified unspecified  	I_PERS	null
5 , , , punctuation unspecified unspecified unspecified unspecified unspecified  	O	null
6 זיו זיו זיו properName unspecified unspecified unspecified unspecified unspecified  	I_PERS	null
7 קסם קסם קסם noun masculine singular absolute unspecified unspecified  	O	null
8 ב ב בחול preposition unspecified unspecified unspecified unspecified unspecified 0 
8 חול חול בחול noun masculine singular construct unspecified unspecified  	O	null
9 - - - punctuation unspecified unspecified unspecified unspecified unspecified  	O	null
10 ה ה המדבר definiteArticle unspecified unspecified unspecified unspecified unspecified 0 
10 המדבר מדבר המדבר noun masculine singular absolute unspecified unspecified  	O	null
11 . . . punctuation unspecified unspecified unspecified unspecified unspecified  	O	null

0 את את אתך at-preposition unspecified unspecified unspecified unspecified unspecified  
0 ך ך אתך pronomial masculine singular unspecified 2 unspecified 0 	O	null
1 מן מן מן preposition unspecified unspecified unspecified unspecified unspecified  	O	null
2 ה ה הגוף definiteArticle unspecified unspecified unspecified unspecified unspecified 0 
2 הגוף גוף הגוף noun masculine singular absolute unspecified unspecified  	O	null
3 נעקרת נעקר נעקרת verb feminine singular unspecified any beinoni  	O	null
4 צפר צפר צפרן noun masculine singular absolute unspecified unspecified  
4 ן ן צפרן possessive feminine plural unspecified 3 unspecified 0 	O	null
5 - - - punctuation unspecified unspecified unspecified unspecified unspecified  	O	null
6 יאוש יאוש יאוש properName unspecified unspecified unspecified unspecified unspecified  	I_ORG	null
7 ה ה האכזר definiteArticle unspecified unspecified unspecified unspecified unspecified 0 
7 האכזר אכזר האכזר adjective masculine singular absolute unspecified unspecified  	O	null
8 . . . punctuation unspecified unspecified unspecified unspecified unspecified  	O	null

0 עת עת עת noun feminine singular construct unspecified unspecified  	O	null
1 נחש נחש נחש noun masculine singular absolute unspecified unspecified  	O	null
2 יזרים הזרים יזרים verb masculine singular unspecified 3 future  	O	null
3 ה ה הירח definiteArticle unspecified unspecified unspecified unspecified unspecified 0 
3 הירח ירח הירח noun masculine singular absolute unspecified unspecified  	O	null
4 , , , punctuation unspecified unspecified unspecified unspecified unspecified  	O	null
5 ענן ענן ענן noun masculine singular absolute unspecified unspecified  	O	null
6 יתבוסס התבוסס יתבוסס verb masculine singular unspecified 3 future  	O	null
7 ב ב בחלב preposition unspecified unspecified unspecified unspecified unspecified 0 
7 חלב חלב בחלב properName unspecified unspecified unspecified unspecified unspecified  	I_LOC	null
8 , , , punctuation unspecified unspecified unspecified unspecified unspecified  	O	null
9 תוך תוך תוך preposition unspecified unspecified unspecified unspecified unspecified  	O	null
10 בכי בכי בכי noun masculine singular absolute unspecified unspecified  	O	null
11 קופץ קפץ קופץ verb masculine singular unspecified any beinoni  	O	null
12 ו ו ושמח conjunction unspecified unspecified unspecified unspecified unspecified 0 
12 שמח שמח ושמח adjective masculine singular absolute unspecified unspecified  	O	null
13 ב ב בתהום preposition unspecified unspecified unspecified unspecified unspecified 0 
13 ה ה בתהום definiteArticle unspecified unspecified unspecified unspecified unspecified 0 
13 התהום תהום בתהום noun feminine singular absolute unspecified unspecified  	O	null
14 - - - punctuation unspecified unspecified unspecified unspecified unspecified  	O	null
15 ה ה החזה definiteArticle unspecified unspecified unspecified unspecified unspecified 0 
15 החזה חזה החזה noun masculine singular absolute unspecified unspecified  	O	null
16 ה ה הלבב definiteArticle unspecified unspecified unspecified unspecified unspecified 0 
16 הלבב לבב הלבב noun masculine singular absolute unspecified unspecified  	O	null
17 . . . punctuation unspecified unspecified unspecified unspecified unspecified  	O	null

0 ידעתי ידע ידעתי verb masculine-and-feminine singular unspecified 1 past  	O	null
1 , , , punctuation unspecified unspecified unspecified unspecified unspecified  	O	null
2 ה ה השחר definiteArticle unspecified unspecified unspecified unspecified unspecified 0 
2 השחר שחר השחר noun masculine singular absolute unspecified unspecified  	O	null
3 יופיע הופיע יופיע verb masculine singular unspecified 3 future  	O	null
4 לשפוך שפך לשפוך verb unspecified unspecified unspecified unspecified infinitive  	O	null
5 את את את at-preposition unspecified unspecified unspecified unspecified unspecified  	O	null
6 אור אור אורו noun masculine singular absolute unspecified unspecified  
6 ו ו אורו possessive masculine singular unspecified 3 unspecified 0 	O	null
7 ב ב בשדות preposition unspecified unspecified unspecified unspecified unspecified 0 
7 שדות שדה בשדות noun masculine plural absolute unspecified unspecified  	O	null
8 , , , punctuation unspecified unspecified unspecified unspecified unspecified  	O	null
9 מ מ מתלם preposition unspecified unspecified unspecified unspecified unspecified 0 
9 תל תל מתלם noun masculine singular absolute unspecified unspecified  
9 ם ם מתלם possessive masculine plural unspecified 3 unspecified 0 	O	null
10 אל אל אל preposition unspecified unspecified unspecified unspecified unspecified  	O	null
11 תלם תל תלם properName unspecified unspecified unspecified unspecified unspecified  	I_PERS	null
12 יניע הניע יניע verb masculine singular unspecified 3 future  	O	null
13 ב ב בקצב preposition unspecified unspecified unspecified unspecified unspecified 0 
13 קצב קצב בקצב noun masculine singular construct unspecified unspecified  	O	null
14 צלצול צלצול צלצול noun masculine singular construct unspecified unspecified  	O	null
15 - - - punctuation unspecified unspecified unspecified unspecified unspecified  	O	null
16 מחרשות מחרשה מחרשות noun feminine plural absolute unspecified unspecified  	O	null
17 . . . punctuation unspecified unspecified unspecified unspecified unspecified  	O	null

0 ידעתי ידע ידעתי verb masculine-and-feminine singular unspecified 1 past  	O	null
1 מבקר מבקר מבקר noun masculine singular absolute unspecified unspecified  	O	null
2 עד עד עד preposition unspecified unspecified unspecified unspecified unspecified  	O	null
3 ערב ערב ערב noun masculine singular construct unspecified unspecified  	O	null
4 ה ה היזע definiteArticle unspecified unspecified unspecified unspecified unspecified 0 
4 היזע יזע היזע noun masculine singular absolute unspecified unspecified  	O	null
5 ה ה הגוף definiteArticle unspecified unspecified unspecified unspecified unspecified 0 
5 הגוף גוף הגוף noun masculine singular absolute unspecified unspecified  	O	null
6 לא לא לא negation unspecified unspecified unspecified unspecified unspecified  	O	null
7 יחדל חדל יחדל verb masculine singular unspecified 3 future  	O	null
8 , , , punctuation unspecified unspecified unspecified unspecified unspecified  	O	null
9 ו ו והלאה conjunction unspecified unspecified unspecified unspecified unspecified 0 
9 הלאה הלאה והלאה adverb unspecified unspecified unspecified unspecified unspecified  	O	null
10 , , , punctuation unspecified unspecified unspecified unspecified unspecified  	O	null
11 ו ו והלאה conjunction unspecified unspecified unspecified unspecified unspecified 0 
11 הלאה הלאה והלאה adverb unspecified unspecified unspecified unspecified unspecified  	O	null
12 בלי בלי בלי preposition unspecified unspecified unspecified unspecified unspecified  	O	null
13 ה ה הרף definiteArticle unspecified unspecified unspecified unspecified unspecified 0 
13 הרף רף הרף noun masculine singular absolute unspecified unspecified  	O	null
14 אמשך נמשך אמשך verb masculine-and-feminine singular unspecified 1 future  	O	null
15 ב ב ברתמות preposition unspecified unspecified unspecified unspecified unspecified 0 
15 רתמות רתמות ברתמות noun feminine singular construct unspecified unspecified  	O	null
16 ה ה העמל definiteArticle unspecified unspecified unspecified unspecified unspecified 0 
16 העמל עמל העמל noun masculine singular absolute unspecified unspecified  	O	null
17 . . . punctuation unspecified unspecified unspecified unspecified unspecified  	O	null

0 כי כי כי conjunction unspecified unspecified unspecified unspecified unspecified  	O	null
1 רב רב רב adjective masculine singular absolute unspecified unspecified  	O	null
2 עוד עוד עוד adverb unspecified unspecified unspecified unspecified unspecified  	O	null
3 , , , punctuation unspecified unspecified unspecified unspecified unspecified  	O	null
4 כי כי כי conjunction unspecified unspecified unspecified unspecified unspecified  	O	null
5 רב רב רב noun masculine singular construct unspecified unspecified  	O	null
6 עוד עוד עוד noun masculine singular construct unspecified unspecified  	O	null
7 ה ה היגע definiteArticle unspecified unspecified unspecified unspecified unspecified 0 
7 היגע יגע היגע noun masculine singular absolute unspecified unspecified  	O	null
8 ב ב בשדות preposition unspecified unspecified unspecified unspecified unspecified 0 
8 שדות שדה בשדות noun masculine plural construct unspecified unspecified  	O	null
9 ה ה השרב definiteArticle unspecified unspecified unspecified unspecified unspecified 0 
9 השרב שרב השרב noun masculine singular absolute unspecified unspecified  	O	null
10 הלוחך הלוחך הלוחך properName unspecified unspecified unspecified unspecified unspecified  	I_PERS	null
11 . . . punctuation unspecified unspecified unspecified unspecified unspecified  	O	null

0 רק רק רק conjunction unspecified unspecified unspecified unspecified unspecified  	O	null
1 כח כוח כח noun masculine plural absolute unspecified unspecified  	O	null
2 אחליפה אחליפה אחליפה verb feminine singular unspecified any beinoni  	O	null
3 , , , punctuation unspecified unspecified unspecified unspecified unspecified  	O	null
4 רק רק רק conjunction unspecified unspecified unspecified unspecified unspecified  	O	null
5 רגע רגע רגע noun masculine singular absolute unspecified unspecified  	O	null
6 אנוח נח אנוח verb masculine-and-feminine singular unspecified 1 future  	O	null
7 ו ו והלאה conjunction unspecified unspecified unspecified unspecified unspecified 0 
7 הלאה הלאה והלאה adverb unspecified unspecified unspecified unspecified unspecified  	O	null
8 אלך הלך אלך verb masculine-and-feminine singular unspecified 1 future  	O	null
9 ב ב בדרך preposition unspecified unspecified unspecified unspecified unspecified 0 
9 ה ה בדרך definiteArticle unspecified unspecified unspecified unspecified unspecified 0 
9 הדרך דרך בדרך noun feminine singular absolute unspecified unspecified  	O	null
10 ה ה הזאת definiteArticle unspecified unspecified unspecified unspecified unspecified 0 
10 הזאת זאת הזאת pronoun feminine singular unspecified 3 unspecified  	O	null
11 או או או conjunction unspecified unspecified unspecified unspecified unspecified  	O	null
12 אחרת אחרת אחרת adverb unspecified unspecified unspecified unspecified unspecified  	O	null
13 , , , punctuation unspecified unspecified unspecified unspecified unspecified  	O	null
14 ו ו ואם conjunction unspecified unspecified unspecified unspecified unspecified 0 
14 אם אם ואם conjunction unspecified unspecified unspecified unspecified unspecified  	O	null
15 אכשל כשל אכשל verb masculine-and-feminine singular unspecified 1 future  	O	null
16 ל ל לזמנים preposition unspecified unspecified unspecified unspecified unspecified 0 
16 ה ה לזמנים definiteArticle unspecified unspecified unspecified unspecified unspecified 0 
16 הזמנים זמן לזמנים noun masculine plural absolute unspecified unspecified  	O	null
17 - - - punctuation unspecified unspecified unspecified unspecified unspecified  	O	null
18 אל אל אליך preposition unspecified unspecified unspecified unspecified unspecified  
18 ך ך אליך pronomial masculine singular unspecified 2 unspecified 0 	O	null
19 , , , punctuation unspecified unspecified unspecified unspecified unspecified  	O	null
20 אל אל אליך preposition unspecified unspecified unspecified unspecified unspecified  
20 ך ך אליך pronomial masculine singular unspecified 2 unspecified 0 	O	null
21 , , , punctuation unspecified unspecified unspecified unspecified unspecified  	I_LOC	null
22 כנרת כנרת כנרת properName unspecified unspecified unspecified unspecified unspecified  	I_PERS	null
23 , , , punctuation unspecified unspecified unspecified unspecified unspecified  	O	null
24 אבוא בא אבוא verb masculine-and-feminine singular unspecified 1 future  	O	null
25 לחדש חידש לחדש verb unspecified unspecified unspecified unspecified infinitive  	O	null
26 עלומים עלום עלומים adjective masculine plural absolute unspecified unspecified  	O	null
27 . . . punctuation unspecified unspecified unspecified unspecified unspecified  	O	null

0 בתהו בתהו בתהו adverb unspecified unspecified unspecified unspecified unspecified  	O	null
1 דממה דממה דממה noun feminine singular absolute unspecified unspecified  	O	null
2 ה ה השוררת definiteArticle unspecified unspecified unspecified unspecified unspecified 0 
2 השוררת שרר השוררת participle feminine singular absolute any unspecified  	O	null
3 תמיד תמיד תמיד adverb unspecified unspecified unspecified unspecified unspecified  	O	null
4 קריאת קריאה קריאתי noun feminine singular absolute unspecified unspecified  
4 י י קריאתי possessive masculine-and-feminine singular unspecified 1 unspecified 0 	O	null
5 תרחף ריחף תרחף verb feminine singular unspecified 3 future  	O	null
6 : : : punctuation unspecified unspecified unspecified unspecified unspecified  	O	null
7 כנרת כנרת כנרת properName unspecified unspecified unspecified unspecified unspecified  	I_LOC	null
8 , , , punctuation unspecified unspecified unspecified unspecified unspecified  	O	null
9 כנרת כנרת כנרת properName unspecified unspecified unspecified unspecified unspecified  	I_LOC	null
10 , , , punctuation unspecified unspecified unspecified unspecified unspecified  	O	null
11 כנרת כנרת כנרת properName unspecified unspecified unspecified unspecified unspecified  	I_LOC	null
12 , , , punctuation unspecified unspecified unspecified unspecified unspecified  	O	null
13 אמצי אמץ אמצי verb feminine singular unspecified 2 imperative  	O	null
14 את את את at-preposition unspecified unspecified unspecified unspecified unspecified  	O	null
15 ה ה הבן definiteArticle unspecified unspecified unspecified unspecified unspecified 0 
15 הבן בן הבן noun masculine singular absolute unspecified unspecified  	O	null
16 העיף העיף העיף verb masculine singular unspecified 3 past  	O	null
17 . . . punctuation unspecified unspecified unspecified unspecified unspecified  	O	null

