0 את את אתי at-preposition unspecified unspecified unspecified unspecified unspecified  
0 י י אתי pronomial masculine-and-feminine singular unspecified 1 unspecified 0 	O	null
1 מ מ מלבנון preposition unspecified unspecified unspecified unspecified unspecified 0 
1 לבנון לבנון מלבנון properName unspecified unspecified unspecified unspecified unspecified  	I_LOC	null
2 , , , punctuation unspecified unspecified unspecified unspecified unspecified  	O	null
3 את את אתי at-preposition unspecified unspecified unspecified unspecified unspecified  
3 י י אתי pronomial masculine-and-feminine singular unspecified 1 unspecified 0 	O	null
4 , , , punctuation unspecified unspecified unspecified unspecified unspecified  	O	null
5 כלה כלה כלה verb masculine singular unspecified 3 past  	O	null
6 , , , punctuation unspecified unspecified unspecified unspecified unspecified  	O	null
7 תבואי בא תבואי verb feminine singular unspecified 2 future  	O	null
8 . . . punctuation unspecified unspecified unspecified unspecified unspecified  	O	null

0 מ מ ממעונות preposition unspecified unspecified unspecified unspecified unspecified 0 
0 מעונות מעון ממעונות noun masculine plural construct unspecified unspecified  	O	null
1 אריות אריה אריות noun masculine plural absolute unspecified unspecified  	O	null
2 , , , punctuation unspecified unspecified unspecified unspecified unspecified  	O	null
3 מ מ מראש preposition unspecified unspecified unspecified unspecified unspecified 0 
3 ראש ראש מראש noun masculine singular construct unspecified unspecified  	O	null
4 שניר שניר שניר properName unspecified unspecified unspecified unspecified unspecified  	I_PERS	null
5 ו ו וחרמון conjunction unspecified unspecified unspecified unspecified unspecified 0 
5 חרמון חרמון וחרמון properName unspecified unspecified unspecified unspecified unspecified  	I_PERS	null
6 . . . punctuation unspecified unspecified unspecified unspecified unspecified  	O	null

0 הנך הוא הנך copula masculine singular unspecified 2 beinoni  	O	null
1 יפה יפה יפה adjective masculine singular absolute unspecified unspecified  	O	null
2 , , , punctuation unspecified unspecified unspecified unspecified unspecified  	O	null
3 רעיתי רעה רעיתי verb masculine-and-feminine singular unspecified 1 past  	O	null
4 , , , punctuation unspecified unspecified unspecified unspecified unspecified  	O	null
5 עין עין עיניך noun feminine plural absolute unspecified unspecified  
5 ך ך עיניך possessive feminine singular unspecified 2 unspecified 0 	O	null
6 יונים יון יונים noun masculine plural absolute unspecified unspecified  	O	null
7 . . . punctuation unspecified unspecified unspecified unspecified unspecified  	O	null

0 זה זה זה pronoun masculine singular unspecified 3 unspecified  	O	null
1 דודי דוד דודי noun masculine plural construct unspecified unspecified  	O	null
2 , , , punctuation unspecified unspecified unspecified unspecified unspecified  	O	null
3 זה זה זה pronoun masculine singular unspecified 3 unspecified  	O	null
4 רעי רעי רעי noun masculine singular absolute unspecified unspecified  	O	null
5 , , , punctuation unspecified unspecified unspecified unspecified unspecified  	O	null
6 בנות בת בנות noun feminine plural construct unspecified unspecified  	O	null
7 ירושלים ירושלים ירושלים properName unspecified unspecified unspecified unspecified unspecified  	I_LOC	null
8 ( ( ( punctuation unspecified unspecified unspecified unspecified unspecified  	O	null
9 זה זה זה pronoun masculine singular unspecified 3 unspecified  	O	null
10 דודי דוד דודי noun masculine plural construct unspecified unspecified  	O	null
11 ) ) ) punctuation unspecified unspecified unspecified unspecified unspecified  	O	null
12 . . . punctuation unspecified unspecified unspecified unspecified unspecified  	O	null

