0 נתחיל התחיל נתחיל verb masculine-and-feminine plural unspecified 1 future  	O	null
1 ילדים ילד ילדים noun masculine plural absolute unspecified unspecified  	O	null
2 מבראשית מבראשית מבראשית adverb unspecified unspecified unspecified unspecified unspecified  	O	null
3 כי כי כי conjunction unspecified unspecified unspecified unspecified unspecified  	O	null
4 כך כך כך pronoun unspecified unspecified unspecified unspecified unspecified  	O	null
5 מתחילים התחיל מתחילים verb masculine plural unspecified any beinoni  	O	null
6 תמיד תמיד תמיד adverb unspecified unspecified unspecified unspecified unspecified  	O	null
7 ב ב בקריאה preposition unspecified unspecified unspecified unspecified unspecified 0 
7 קריאה קריאה בקריאה noun feminine singular absolute unspecified unspecified  	O	null
8 מתחילים התחיל מתחילים verb masculine plural unspecified any beinoni  	O	null
9 מ מ מאלף preposition unspecified unspecified unspecified unspecified unspecified 0 
9 אלף ORD-CARD1000 מאלף numeral masculine plural absolute unspecified unspecified  	O	null
10 בית בית בית noun masculine singular absolute unspecified unspecified  	O	null
11 ב ב בשירה preposition unspecified unspecified unspecified unspecified unspecified 0 
11 ה ה בשירה definiteArticle unspecified unspecified unspecified unspecified unspecified 0 
11 השירה שירה בשירה noun feminine singular absolute unspecified unspecified  	O	null
12 מתחילים התחיל מתחילים verb masculine plural unspecified any beinoni  	O	null
13 מ מ מדו preposition unspecified unspecified unspecified unspecified unspecified 0 
13 דו דו מדו properName unspecified unspecified unspecified unspecified unspecified  	I_PERS	null
14 רה רה רה properName unspecified unspecified unspecified unspecified unspecified  	I_PERS	null
15 מי מי מי properName masculine singular unspecified unspecified unspecified  	O	null
16 שלושה CARD3 שלושה numeral masculine plural absolute unspecified unspecified  	O	null
17 תווים תו תווים noun masculine plural absolute unspecified unspecified  	O	null
18 ראשונים ראשונים ראשונים noun masculine plural absolute unspecified unspecified  	O	null
19 תמיד תמיד תמיד adverb unspecified unspecified unspecified unspecified unspecified  	O	null
20 דו דו דו properName masculine singular unspecified unspecified unspecified  	I_PERS	null
21 רה רה רה properName unspecified unspecified unspecified unspecified unspecified  	I_PERS	null
22 מי מי מי properName masculine singular unspecified unspecified unspecified  	I_PERS	null
23 דו דו דו properName unspecified unspecified unspecified unspecified unspecified  	I_PERS	null
24 רה רה רה properName unspecified unspecified unspecified unspecified unspecified  	I_PERS	null
25 מי מי מי interrogative unspecified unspecified unspecified unspecified unspecified  	O	null
26 פה פה פה adverb unspecified unspecified unspecified unspecified unspecified  	O	null
27 סול סול סול properName unspecified unspecified unspecified unspecified unspecified  	I_PERS	null
28 לה לה לה properName unspecified unspecified unspecified unspecified unspecified  	I_PERS	null
29 סי סי סי properName unspecified unspecified unspecified unspecified unspecified  	I_PERS	null
30 דו דו דו properName masculine singular unspecified unspecified unspecified  	I_PERS	null

0 דו דו דו properName masculine singular unspecified unspecified unspecified  	O	null
1 הוא הוא הוא pronoun masculine singular unspecified 3 unspecified  	O	null
2 דוב דוב דוב noun masculine singular absolute unspecified unspecified  	O	null
3 לבן לבן לבן adjective masculine singular absolute unspecified unspecified  	O	null
4 צפוני צפוני צפוני adjective masculine singular absolute unspecified unspecified  	O	null
5 רה רה רה properName masculine singular unspecified unspecified unspecified  	O	null
6 הוא הוא הוא pronoun masculine singular unspecified 3 unspecified  	O	null
7 רע רע רע noun masculine singular absolute unspecified unspecified  	O	null
8 מאוכזב אוכזב מאוכזב verb masculine singular unspecified any beinoni  	O	null
9 מי מי מי interrogative unspecified unspecified unspecified unspecified unspecified  	O	null
10 דופק דפק דופק verb masculine singular unspecified any beinoni  	O	null
11 על על על preposition unspecified unspecified unspecified unspecified unspecified  	O	null
12 חלון חילון חלוני noun masculine singular absolute unspecified unspecified  
12 י י חלוני possessive masculine-and-feminine singular unspecified 1 unspecified 0 	O	null
13 פה פה פה adverb unspecified unspecified unspecified unspecified unspecified  	O	null
14 ילדה ילד ילדה verb feminine singular unspecified 3 past  	O	null
15 יפה יפה יפה adverb unspecified unspecified unspecified unspecified unspecified  	O	null
16 אוהב אהב אוהב verb masculine singular unspecified any beinoni  	O	null
17 סול סול סול properName unspecified unspecified unspecified unspecified unspecified  	I_PERS	null
18 סולחים סלח סולחים verb masculine plural unspecified any beinoni  	O	null
19 ל ל לו preposition unspecified unspecified unspecified unspecified unspecified  
19 ו ו לו pronomial masculine singular unspecified 3 unspecified 0 	O	null
20 על על על preposition unspecified unspecified unspecified unspecified unspecified  	O	null
21 ה ה הכול definiteArticle unspecified unspecified unspecified unspecified unspecified 0 
21 הכול כול הכול quantifier unspecified unspecified unspecified unspecified unspecified  	O	null
22 ל ל לה preposition unspecified unspecified unspecified unspecified unspecified  
22 ה ה לה pronomial feminine singular unspecified 3 unspecified 0 	O	null
23 קוראים קרא קוראים verb masculine plural unspecified any beinoni  	O	null
24 ל ל לאהובה preposition unspecified unspecified unspecified unspecified unspecified 0 
24 אהובה אהובה לאהובה properName unspecified unspecified unspecified unspecified unspecified  	I_PERS	null
25 סי סי סי properName unspecified unspecified unspecified unspecified unspecified  	I_PERS	null
26 סלחי סלח סלחי verb feminine singular unspecified 2 imperative  	O	null
27 נא נא נא interjection unspecified unspecified unspecified unspecified unspecified  	O	null
28 חביבה חביב חביבה properName unspecified unspecified unspecified unspecified unspecified  	I_PERS	null
29 דוב דוב דוב properName unspecified unspecified unspecified unspecified unspecified  	I_PERS	null
30 אוהב אהב אוהב verb masculine singular unspecified any beinoni  	O	null
31 את את אותך at-preposition unspecified unspecified unspecified unspecified unspecified  
31 ך ך אותך pronomial masculine singular unspecified 2 unspecified 0 	O	null
32 נורא נורא נורא adverb unspecified unspecified unspecified unspecified unspecified  	O	null

0 אם אם אם conjunction unspecified unspecified unspecified unspecified unspecified  	O	null
1 יודעים ידע יודעים verb masculine plural unspecified any beinoni  	O	null
2 לקרוא קרא לקרוא verb unspecified unspecified unspecified unspecified infinitive  	O	null
3 תווים תו תווים noun masculine plural absolute unspecified unspecified  	O	null
4 מיותר מיותר מיותר adjective masculine singular absolute unspecified unspecified  	O	null
5 לזכור זכר לזכור verb unspecified unspecified unspecified unspecified infinitive  	O	null
6 מילים מילה מילים noun feminine plural absolute unspecified unspecified  	O	null

