0 שלחתי שלח שלחתי verb masculine-and-feminine singular unspecified 1 past  	O	null
1 את את את at-preposition unspecified unspecified unspecified unspecified unspecified  	O	null
2 שירי שיר שירי noun masculine plural construct unspecified unspecified  	O	null
3 ב ב בצהלה preposition unspecified unspecified unspecified unspecified unspecified 0 
3 צהלה צהלה בצהלה properName unspecified unspecified unspecified unspecified unspecified  	I_PERS	null
4 לה לה לה properName unspecified unspecified unspecified unspecified unspecified  	I_PERS	null
5 לה לה לה properName unspecified unspecified unspecified unspecified unspecified  	I_PERS	null
6 לה לה לה properName unspecified unspecified unspecified unspecified unspecified  	I_PERS	null
7 לה לה לה properName unspecified unspecified unspecified unspecified unspecified  	I_PERS	null
8 לה לה לה properName unspecified unspecified unspecified unspecified unspecified  	I_PERS	null
9 חיפש חיפש חיפש verb masculine singular unspecified 3 past  	O	null
10 קולות קול קולות noun masculine plural construct unspecified unspecified  	O	null
11 ילדה ילד ילדה noun feminine singular absolute unspecified unspecified  	O	null
12 ש ש שיענו relativizer/subordinatingConjunction unspecified unspecified unspecified unspecified unspecified 0 
12 יענו ענה שיענו verb masculine-and-feminine plural unspecified 3 future  	O	null
13 נו נו נו interjection unspecified unspecified unspecified unspecified unspecified  	O	null
14 נו נו נו interjection unspecified unspecified unspecified unspecified unspecified  	O	null
15 נו נו נו interjection unspecified unspecified unspecified unspecified unspecified  	O	null
16 ו ו וכשחזר conjunction unspecified unspecified unspecified unspecified unspecified 0 
16 כש כש וכשחזר temporalSubConj unspecified unspecified unspecified unspecified unspecified 0 
16 חזר חזר וכשחזר verb masculine singular unspecified 3 past  	O	null
17 אל אל אלי preposition unspecified unspecified unspecified unspecified unspecified  
17 י י אלי pronomial masculine-and-feminine singular unspecified 1 unspecified 0 	O	null
18 ב ב ברוח preposition unspecified unspecified unspecified unspecified unspecified 0 
18 ה ה ברוח definiteArticle unspecified unspecified unspecified unspecified unspecified 0 
18 הרוח רוח ברוח noun feminine singular absolute unspecified unspecified  	O	null
19 ה ה הקלה definiteArticle unspecified unspecified unspecified unspecified unspecified 0 
19 הקלה קל הקלה adjective feminine singular absolute unspecified unspecified  	O	null
20 לא לא לא negation unspecified unspecified unspecified unspecified unspecified  	O	null
21 היא הוא היא pronoun feminine singular unspecified 3 unspecified  	O	null
22 היתה הוא היתה copula feminine singular unspecified 3 past  	O	null
23 זו זו זו pronoun feminine singular unspecified 3 unspecified  	O	null
24 ש ש שנתנה relativizer/subordinatingConjunction unspecified unspecified unspecified unspecified unspecified 0 
24 נתנה נתן שנתנה verb feminine singular unspecified 3 past  	O	null
25 קולה קולה קולה noun feminine singular absolute unspecified unspecified  	O	null

0 לה לה לה properName unspecified unspecified unspecified unspecified unspecified  	I_PERS	null
1 לה לה לה properName unspecified unspecified unspecified unspecified unspecified  	I_PERS	null
2 לה לה לה properName unspecified unspecified unspecified unspecified unspecified  	I_PERS	null
3 לה לה לה properName unspecified unspecified unspecified unspecified unspecified  	I_PERS	null
4 לה לה לה properName unspecified unspecified unspecified unspecified unspecified  	I_PERS	null
5 לה לה לה properName unspecified unspecified unspecified unspecified unspecified  	I_PERS	null
6 לה... לה... לה... properName unspecified unspecified unspecified unspecified unspecified  	I_PERS	null

0 המשיך המשיך המשיך verb masculine singular unspecified 3 past  	O	null
1 שירי שירי שירי properName unspecified unspecified unspecified unspecified unspecified  	I_PERS	null
2 לנדוד נדד לנדוד verb unspecified unspecified unspecified unspecified infinitive  	O	null
3 שם שם שם adverb unspecified unspecified unspecified unspecified unspecified  	O	null
4 ב ב בדממה preposition unspecified unspecified unspecified unspecified unspecified 0 
4 דממה דממה בדממה noun feminine singular absolute unspecified unspecified  	O	null
5 מה מה מה interrogative unspecified unspecified unspecified unspecified unspecified  	O	null
6 מה מה מה interrogative unspecified unspecified unspecified unspecified unspecified  	O	null
7 מה מה מה interrogative unspecified unspecified unspecified unspecified unspecified  	O	null
8 מה מה מה interrogative unspecified unspecified unspecified unspecified unspecified  	O	null
9 לשמוע שמע לשמוע verb unspecified unspecified unspecified unspecified infinitive  	O	null
10 את את את at-preposition unspecified unspecified unspecified unspecified unspecified  	O	null
11 הד הד הדו noun masculine singular absolute unspecified unspecified  
11 ו ו הדו possessive masculine singular unspecified 3 unspecified 0 	O	null
12 ביקש ביקש ביקש verb masculine singular unspecified 3 past  	O	null
13 מאד מאוד מאד adverb unspecified unspecified unspecified unspecified unspecified  	O	null
14 אד אד אד noun masculine singular construct unspecified unspecified  	O	null
15 אד אד אד noun masculine singular construct unspecified unspecified  	O	null
16 אד אד אד noun masculine singular absolute unspecified unspecified  	O	null
17 ו ו וכל conjunction unspecified unspecified unspecified unspecified unspecified 0 
17 כל כול וכל quantifier unspecified unspecified construct unspecified unspecified  	O	null
18 ה ה הנערות definiteArticle unspecified unspecified unspecified unspecified unspecified 0 
18 הנערות נער הנערות noun feminine plural absolute unspecified unspecified  	O	null
19 כבר כבר כבר adverb unspecified unspecified unspecified unspecified unspecified  	O	null
20 שרו שר שרו verb masculine-and-feminine plural unspecified 3 past  	O	null
21 ל ל לי preposition unspecified unspecified unspecified unspecified unspecified  
21 י י לי pronomial masculine-and-feminine singular unspecified 1 unspecified 0 	O	null
22 את את את at-preposition unspecified unspecified unspecified unspecified unspecified  	O	null
23 שם שם שמה noun masculine singular absolute unspecified unspecified  
23 ה ה שמה possessive feminine singular unspecified 3 unspecified 0 	O	null
24 ו ו ורק conjunction unspecified unspecified unspecified unspecified unspecified 0 
24 רק רק ורק conjunction unspecified unspecified unspecified unspecified unspecified  	O	null
25 קולה קולה קולה noun feminine singular absolute unspecified unspecified  	O	null
26 של של שלה shel-preposition unspecified unspecified unspecified unspecified unspecified  
26 ה ה שלה pronomial feminine singular unspecified 3 unspecified 0 	O	null
27 חסר חסר חסר verb masculine singular unspecified 3 past  	O	null
28 שם שם שם adverb unspecified unspecified unspecified unspecified unspecified  	O	null
29 עוד עוד עוד adverb unspecified unspecified unspecified unspecified unspecified  	O	null

0 לה לה לה properName unspecified unspecified unspecified unspecified unspecified  	I_PERS	null
1 לה לה לה properName unspecified unspecified unspecified unspecified unspecified  	I_PERS	null
2 לה לה לה properName unspecified unspecified unspecified unspecified unspecified  	I_PERS	null
3 לה לה לה properName unspecified unspecified unspecified unspecified unspecified  	I_PERS	null
4 לה לה לה properName unspecified unspecified unspecified unspecified unspecified  	I_PERS	null
5 לה לה לה properName unspecified unspecified unspecified unspecified unspecified  	I_PERS	null
6 לה... לה... לה... properName unspecified unspecified unspecified unspecified unspecified  	I_PERS	null

0 ו ו ושוב conjunction unspecified unspecified unspecified unspecified unspecified 0 
0 שוב שוב ושוב adverb unspecified unspecified unspecified unspecified unspecified  	O	null
1 חזר חזר חזר verb masculine singular unspecified 3 past  	O	null
2 אל אל אלי preposition unspecified unspecified unspecified unspecified unspecified  
2 י י אלי pronomial masculine-and-feminine singular unspecified 1 unspecified 0 	O	null
3 רק רק רק conjunction unspecified unspecified unspecified unspecified unspecified  	O	null
4 הד הד הד noun masculine singular construct unspecified unspecified  	O	null
5 ה ה הצליל definiteArticle unspecified unspecified unspecified unspecified unspecified 0 
5 הצליל צליל הצליל noun masculine singular absolute unspecified unspecified  	O	null
6 ליל ליל ליל noun masculine singular construct unspecified unspecified  	O	null
7 ליל ליל ליל noun masculine singular construct unspecified unspecified  	O	null
8 ליל ליל ליל noun masculine singular construct unspecified unspecified  	O	null
9 ליל ליל ליל noun masculine singular construct unspecified unspecified  	O	null
10 כל כול כל quantifier unspecified unspecified construct unspecified unspecified  	O	null
11 ה ה הבנות definiteArticle unspecified unspecified unspecified unspecified unspecified 0 
11 הבנות בת הבנות noun feminine plural absolute unspecified unspecified  	O	null
12 נתנו נתן נתנו verb masculine-and-feminine plural unspecified 3 past  	O	null
13 מ מ מזמן preposition unspecified unspecified unspecified unspecified unspecified 0 
13 זמן זמן מזמן noun masculine singular construct unspecified unspecified  	O	null
14 קולן קולן קולן noun masculine singular absolute unspecified unspecified  	O	null
15 לן לן לן verb masculine singular unspecified 3 past  	O	null
16 לן לן לן verb masculine singular unspecified 3 past  	O	null
17 לן לן לן verb masculine singular unspecified 3 past  	O	null
18 אם אם אם conjunction unspecified unspecified unspecified unspecified unspecified  	O	null
19 לא לא לא negation unspecified unspecified unspecified unspecified unspecified  	O	null
20 אשמע שמע אשמע verb masculine-and-feminine singular unspecified 1 future  	O	null
21 קול קול קולך noun masculine singular absolute unspecified unspecified  
21 ך ך קולך possessive feminine singular unspecified 2 unspecified 0 	O	null
22 , , , punctuation unspecified unspecified unspecified unspecified unspecified  	O	null
23 אם אם אם conjunction unspecified unspecified unspecified unspecified unspecified  	O	null
24 לא לא לא negation unspecified unspecified unspecified unspecified unspecified  	O	null
25 תשיבי השיב תשיבי verb feminine singular unspecified 2 future  	O	null
26 ל ל לי preposition unspecified unspecified unspecified unspecified unspecified  
26 י י לי pronomial masculine-and-feminine singular unspecified 1 unspecified 0 	O	null
27 שוב שוב שוב adverb unspecified unspecified unspecified unspecified unspecified  	O	null
28 אשלח שלח אשלח verb masculine-and-feminine singular unspecified 1 future  	O	null
29 את את אותו at-preposition unspecified unspecified unspecified unspecified unspecified  
29 ו ו אותו pronomial masculine singular unspecified 3 unspecified 0 	O	null
30 אל אל אל preposition unspecified unspecified unspecified unspecified unspecified  	O	null
31 ה ה העולם definiteArticle unspecified unspecified unspecified unspecified unspecified 0 
31 העולם עולם העולם noun masculine singular absolute unspecified unspecified  	O	null

0 לה לה לה properName unspecified unspecified unspecified unspecified unspecified  	I_PERS	null
1 לה לה לה properName unspecified unspecified unspecified unspecified unspecified  	I_PERS	null
2 לה לה לה properName unspecified unspecified unspecified unspecified unspecified  	I_PERS	null
3 לה לה לה properName unspecified unspecified unspecified unspecified unspecified  	I_PERS	null
4 לה לה לה properName unspecified unspecified unspecified unspecified unspecified  	I_PERS	null
5 לה לה לה properName unspecified unspecified unspecified unspecified unspecified  	I_PERS	null
6 לה... לה... לה... properName unspecified unspecified unspecified unspecified unspecified  	I_PERS	null

