0 חום חום חום noun masculine singular construct unspecified unspecified  	O	null
1 ה ה השמש definiteArticle unspecified unspecified unspecified unspecified unspecified 0 
1 השמש שמש השמש noun feminine singular absolute unspecified unspecified  	O	null
2 ה ה העולה definiteArticle unspecified unspecified unspecified unspecified unspecified 0 
2 העולה עלה העולה participle feminine singular absolute any unspecified  	O	null
3 ו ו ויוקדת conjunction unspecified unspecified unspecified unspecified unspecified 0 
3 יוקדת יקד ויוקדת verb feminine singular unspecified any beinoni  	O	null
4 , , , punctuation unspecified unspecified unspecified unspecified unspecified  	O	null
5 ה ה הסופות definiteArticle unspecified unspecified unspecified unspecified unspecified 0 
5 הסופות סופה הסופות noun feminine plural absolute unspecified unspecified  	O	null
6 תבואנה בא תבואנה verb feminine plural unspecified 3 future  	O	null
7 , , , punctuation unspecified unspecified unspecified unspecified unspecified  	O	null
8 כי כי כי conjunction unspecified unspecified unspecified unspecified unspecified  	O	null
9 ה ה הדרך definiteArticle unspecified unspecified unspecified unspecified unspecified 0 
9 הדרך דרך הדרך noun feminine singular absolute unspecified unspecified  	O	null
10 ש ש שלסדום relativizer/subordinatingConjunction unspecified unspecified unspecified unspecified unspecified 0 
10 ל ל שלסדום preposition unspecified unspecified unspecified unspecified unspecified 0 
10 סדום סדום שלסדום properName masculine singular unspecified unspecified unspecified  	I_LOC	null
11 אט אט אט adverb unspecified unspecified unspecified unspecified unspecified  	O	null
12 יורדת ירד יורדת verb feminine singular unspecified any beinoni  	O	null
13 שם שם שם adverb unspecified unspecified unspecified unspecified unspecified  	O	null
14 כביש כביש כביש noun masculine singular construct unspecified unspecified  	I_LOC	null
15 דימונה דימונה דימונה properName unspecified unspecified unspecified unspecified unspecified  	I_LOC	null
16 . . . punctuation unspecified unspecified unspecified unspecified unspecified  	O	null

0 אל אל אל negation unspecified unspecified unspecified unspecified unspecified  	O	null
1 תלך הלך תלך verb feminine singular unspecified 3 future  	O	null
2 ל ל לשם preposition unspecified unspecified unspecified unspecified unspecified 0 
2 ה ה לשם definiteArticle unspecified unspecified unspecified unspecified unspecified 0 
2 השם שם לשם noun masculine singular absolute unspecified unspecified  	O	null
3 , , , punctuation unspecified unspecified unspecified unspecified unspecified  	O	null
4 שם שם שם adverb unspecified unspecified unspecified unspecified unspecified  	O	null
5 לוהט לוהט לוהט adjective masculine singular absolute unspecified unspecified  	O	null
6 ה ה הדרום definiteArticle unspecified unspecified unspecified unspecified unspecified 0 
6 הדרום דרום הדרום noun masculine singular absolute unspecified unspecified  	O	null
7 . . . punctuation unspecified unspecified unspecified unspecified unspecified  	O	null

0 אל אל אל negation unspecified unspecified unspecified unspecified unspecified  	O	null
1 תלך הלך תלך verb feminine singular unspecified 3 future  	O	null
2 לשם לשם לשם preposition unspecified unspecified unspecified unspecified unspecified  	O	null
3 כי כי כי conjunction unspecified unspecified unspecified unspecified unspecified  	O	null
4 בוער בער בוער verb masculine singular unspecified any beinoni  	O	null
5 כי כי כי conjunction unspecified unspecified unspecified unspecified unspecified  	O	null
6 בוער בער בוער verb masculine singular unspecified any beinoni  	O	null
7 שם שם שם adverb unspecified unspecified unspecified unspecified unspecified  	O	null
8 ב ב בסדום preposition unspecified unspecified unspecified unspecified unspecified 0 
8 סדום סדום בסדום properName unspecified unspecified unspecified unspecified unspecified  	I_LOC	null
9 . . . punctuation unspecified unspecified unspecified unspecified unspecified  	O	null

0 אור אור אור noun masculine singular construct unspecified unspecified  	O	null
1 ירח ירח ירח noun masculine singular absolute unspecified unspecified  	O	null
2 לא לא לא negation unspecified unspecified unspecified unspecified unspecified  	O	null
3 זרח זרח זרח verb masculine singular unspecified 3 past  	O	null
4 ב ב בשמים preposition unspecified unspecified unspecified unspecified unspecified 0 
4 שמים שמי בשמים noun masculine plural absolute unspecified unspecified  	O	null
5 אם אם אם conjunction unspecified unspecified unspecified unspecified unspecified  	O	null
6 ל ל לסדום preposition unspecified unspecified unspecified unspecified unspecified 0 
6 סדום סדום לסדום properName masculine singular unspecified unspecified unspecified  	I_LOC	null
7 תבואנה בא תבואנה verb feminine plural unspecified 3 future  	O	null
8 טעם טעם טעם noun masculine singular absolute unspecified unspecified  	O	null
9 מלח מלח מלח noun masculine singular absolute unspecified unspecified  	O	null
10 שם שם שם adverb unspecified unspecified unspecified unspecified unspecified  	O	null
11 צורב צרב צורב verb masculine singular unspecified any beinoni  	O	null
12 כל כול כל quantifier unspecified unspecified construct unspecified unspecified  	O	null
13 ש ש שפתיים relativizer/subordinatingConjunction unspecified unspecified unspecified unspecified unspecified 0 
13 פתיים פתי שפתיים noun masculine plural absolute unspecified unspecified  	O	null
14 , , , punctuation unspecified unspecified unspecified unspecified unspecified  	O	null
15 גם גם גם conjunction unspecified unspecified unspecified unspecified unspecified  	O	null
16 את את את at-preposition unspecified unspecified unspecified unspecified unspecified  	O	null
17 כביש כביש כביש noun masculine singular construct unspecified unspecified  	O	null
18 דימונה דימונה דימונה properName unspecified unspecified unspecified unspecified unspecified  	I_LOC	null
19 . . . punctuation unspecified unspecified unspecified unspecified unspecified  	O	null

0 אל אל אל negation unspecified unspecified unspecified unspecified unspecified  	O	null
1 תלך הלך תלך verb feminine singular unspecified 3 future  	O	null
2 לשם... לשם... לשם... verb feminine singular unspecified 2 imperative  	O	null

