0 ב ב בלילה preposition unspecified unspecified unspecified unspecified unspecified 0 
0 לילה לילה בלילה noun masculine singular absolute unspecified unspecified  	O	null
1 עטוף עטוף עטוף adjective masculine singular absolute unspecified unspecified  	O	null
2 כוכבים כוכב כוכבים noun masculine plural absolute unspecified unspecified  	O	null
3 יצאו יצא יצאו verb masculine-and-feminine plural unspecified 3 past  	O	null
4 ל ל לדרכם preposition unspecified unspecified unspecified unspecified unspecified 0 
4 דרך דרך לדרכם noun feminine singular absolute unspecified unspecified  
4 ם ם לדרכם possessive masculine plural unspecified 3 unspecified 0 	O	null
5 עם עם עם preposition unspecified unspecified unspecified unspecified unspecified  	O	null
6 ה ה הרוח definiteArticle unspecified unspecified unspecified unspecified unspecified 0 
6 הרוח רוח הרוח noun feminine singular absolute unspecified unspecified  	O	null
7 . . . punctuation unspecified unspecified unspecified unspecified unspecified  	O	null

0 שלושה CARD3 שלושה numeral masculine plural absolute unspecified unspecified  	O	null
1 על על על preposition unspecified unspecified unspecified unspecified unspecified  	O	null
2 סוסים סוס סוסים noun masculine plural absolute unspecified unspecified  	O	null
3 דוהרים דהר דוהרים verb masculine plural unspecified any beinoni  	O	null
4 רכבו רכב רכבו verb masculine-and-feminine plural unspecified 3 past  	O	null
5 ב ב במדבר preposition unspecified unspecified unspecified unspecified unspecified 0 
5 ה ה במדבר definiteArticle unspecified unspecified unspecified unspecified unspecified 0 
5 המדבר מדבר במדבר noun masculine singular absolute unspecified unspecified  	O	null
6 ה ה הפרוע definiteArticle unspecified unspecified unspecified unspecified unspecified 0 
6 הפרוע פרוע הפרוע adjective masculine singular absolute unspecified unspecified  	O	null
7 . . . punctuation unspecified unspecified unspecified unspecified unspecified  	O	null

0 ב ב בנפול preposition unspecified unspecified unspecified unspecified unspecified 0 
0 נפול נפול בנפול adjective masculine singular absolute unspecified unspecified  	O	null
1 עוד עוד עוד adverb unspecified unspecified unspecified unspecified unspecified  	O	null
2 כוכב כוכב כוכב noun masculine singular absolute unspecified unspecified  	O	null
3 נכנסו נכנס נכנסו verb masculine-and-feminine plural unspecified 3 past  	O	null
4 אל אל אל preposition unspecified unspecified unspecified unspecified unspecified  	O	null
5 ה ה הכפר definiteArticle unspecified unspecified unspecified unspecified unspecified 0 
5 הכפר כפר הכפר noun masculine singular absolute unspecified unspecified  	O	null
6 , , , punctuation unspecified unspecified unspecified unspecified unspecified  	O	null
7 קשרו קשר קשרו verb masculine-and-feminine plural unspecified 3 past  	O	null
8 ה ה הסוסים definiteArticle unspecified unspecified unspecified unspecified unspecified 0 
8 הסוסים סוס הסוסים noun masculine plural absolute unspecified unspecified  	O	null
9 מול מול מול preposition unspecified unspecified unspecified unspecified unspecified  	O	null
10 מרזח מרזח מרזח noun masculine singular absolute unspecified unspecified  	O	null
11 , , , punctuation unspecified unspecified unspecified unspecified unspecified  	O	null
12 שלפו שלף שלפו verb masculine-and-feminine plural unspecified 3 past  	O	null
13 אקדחים אקדח אקדחים noun masculine plural absolute unspecified unspecified  	O	null
14 נכנסו נכנס נכנסו verb masculine-and-feminine plural unspecified 3 past  	O	null
15 אל אל אל preposition unspecified unspecified unspecified unspecified unspecified  	O	null
16 ה ה הבר definiteArticle unspecified unspecified unspecified unspecified unspecified 0 
16 הבר בר הבר properName unspecified unspecified unspecified unspecified unspecified  	I_PERS	null
17 לא לא לא negation unspecified unspecified unspecified unspecified unspecified  	O	null
18 חיכו חייך חיכו verb masculine-and-feminine plural unspecified 3 past  	O	null
19 שניה שנייה שניה noun feminine singular absolute unspecified unspecified  	O	null
20 להתמתח התמתח להתמתח verb unspecified unspecified unspecified unspecified infinitive  	O	null
21 . . . punctuation unspecified unspecified unspecified unspecified unspecified  	O	null

0 ב ב בים preposition unspecified unspecified unspecified unspecified unspecified 0 
0 ים ים בים noun masculine singular construct unspecified unspecified  	O	null
1 ה ה המדבר definiteArticle unspecified unspecified unspecified unspecified unspecified 0 
1 המדבר מדבר המדבר noun masculine singular absolute unspecified unspecified  	O	null
2 בין בין בין preposition unspecified unspecified unspecified unspecified unspecified  	O	null
3 וואדי ואדי וואדי noun masculine singular absolute unspecified unspecified  	O	null
4 ל ל להר preposition unspecified unspecified unspecified unspecified unspecified 0 
4 ה ה להר definiteArticle unspecified unspecified unspecified unspecified unspecified 0 
4 ההר הר להר noun masculine singular absolute unspecified unspecified  	O	null
5 הם הוא הם pronoun masculine plural unspecified 3 unspecified  	O	null
6 נעו נע נעו verb masculine-and-feminine plural unspecified 3 past  	O	null
7 . . . punctuation unspecified unspecified unspecified unspecified unspecified  	O	null

0 מעבר מעבר מעבר noun masculine singular absolute unspecified unspecified  	O	null
1 ל ל לנוף preposition unspecified unspecified unspecified unspecified unspecified 0 
1 נוף נוף לנוף noun masculine singular construct unspecified unspecified  	O	null
2 עד עד עד noun masculine singular absolute unspecified unspecified  	O	null
3 ש ש שלבסוף relativizer/subordinatingConjunction unspecified unspecified unspecified unspecified unspecified 0 
3 לבסוף לבסוף שלבסוף adverb unspecified unspecified unspecified unspecified unspecified  	O	null
4 הם הוא הם pronoun masculine plural unspecified 3 unspecified  	O	null
5 באו בא באו verb masculine-and-feminine plural unspecified 3 past  	O	null
6 , , , punctuation unspecified unspecified unspecified unspecified unspecified  	O	null
7 אל אל אל preposition unspecified unspecified unspecified unspecified unspecified  	O	null
8 ה ה הכפר definiteArticle unspecified unspecified unspecified unspecified unspecified 0 
8 הכפר כפר הכפר noun masculine singular absolute unspecified unspecified  	O	null
9 . . . punctuation unspecified unspecified unspecified unspecified unspecified  	O	null

0 מ מ מאמצע preposition unspecified unspecified unspecified unspecified unspecified 0 
0 אמצע אמצע מאמצע noun masculine singular construct unspecified unspecified  	O	null
1 הבר בר הבר properName unspecified unspecified unspecified unspecified unspecified  	I_PERS	null
2 ה ה הסואן definiteArticle unspecified unspecified unspecified unspecified unspecified 0 
2 הסואן סואן הסואן adjective masculine singular absolute unspecified unspecified  	O	null
3 העיפו העיף העיפו verb masculine-and-feminine plural unspecified 3 past  	O	null
4 מבט מבט מבט noun masculine singular absolute unspecified unspecified  	O	null
5 מנתח מנתח מנתח noun masculine singular absolute unspecified unspecified  	O	null
6 . . . punctuation unspecified unspecified unspecified unspecified unspecified  	O	null

0 הפסיק הפסיק הפסיק verb masculine singular unspecified 3 past  	O	null
1 ה ה הפסנתרן definiteArticle unspecified unspecified unspecified unspecified unspecified 0 
1 הפסנתרן פסנתרן הפסנתרן noun masculine singular absolute unspecified unspecified  	O	null
2 לנגן ניגן לנגן verb unspecified unspecified unspecified unspecified infinitive  	O	null
3 , , , punctuation unspecified unspecified unspecified unspecified unspecified  	O	null
4 מוזג מוזג מוזג noun masculine singular absolute unspecified unspecified  	O	null
5 מבוהל מבוהל מבוהל adjective masculine singular absolute unspecified unspecified  	O	null
6 השתטח השתטח השתטח verb masculine singular unspecified 3 past  	O	null
7 . . . punctuation unspecified unspecified unspecified unspecified unspecified  	O	null

0 שאל שאל שאל verb masculine singular unspecified 3 past  	O	null
1 ה ה הראשון definiteArticle unspecified unspecified unspecified unspecified unspecified 0 
1 הראשון ORD1 הראשון numeral masculine singular absolute unspecified unspecified  	O	null
2 ש ש שעמד relativizer/subordinatingConjunction unspecified unspecified unspecified unspecified unspecified 0 
2 עמד עמד שעמד verb masculine singular unspecified 3 past  	O	null
3 משופם משופם משופם adjective masculine singular absolute unspecified unspecified  	O	null
4 , , , punctuation unspecified unspecified unspecified unspecified unspecified  	O	null
5 ב ב בשריף preposition unspecified unspecified unspecified unspecified unspecified 0 
5 שריף שריף בשריף properName unspecified unspecified unspecified unspecified unspecified  	I_PERS	null
6 מחזיק החזיק מחזיק verb masculine singular unspecified any beinoni  	O	null
7 ללא ללא ללא preposition unspecified unspecified unspecified unspecified unspecified  	O	null
8 רתע רתע רתע properName unspecified unspecified unspecified unspecified unspecified  	I_PERS	null
9 , , , punctuation unspecified unspecified unspecified unspecified unspecified  	O	null
10 " " " punctuation unspecified unspecified unspecified unspecified unspecified  	O	null
11 איפה איפה איפה noun feminine singular absolute unspecified unspecified  	O	null
12 מסתובב הסתובב מסתובב verb masculine singular unspecified any beinoni  	O	null
13 בילי בילי בילי properName unspecified unspecified unspecified unspecified unspecified  	I_PERS	null
14 בוי בוי בוי properName unspecified unspecified unspecified unspecified unspecified  	I_PERS	null
15 הקלפן הקלפן הקלפן properName unspecified unspecified unspecified unspecified unspecified  	I_PERS	null
16 ? ? ? punctuation unspecified unspecified unspecified unspecified unspecified  	O	null
17 " " " punctuation unspecified unspecified unspecified unspecified unspecified  	O	null
18 ו ו ואז conjunction unspecified unspecified unspecified unspecified unspecified 0 
18 אז אז ואז conjunction unspecified unspecified unspecified unspecified unspecified  	O	null
19 בילי בילי בילי properName unspecified unspecified unspecified unspecified unspecified  	I_PERS	null
20 בוי בוי בוי properName unspecified unspecified unspecified unspecified unspecified  	I_PERS	null
21 נעמד נעמד נעמד verb masculine singular unspecified 3 past  	O	null
22 לפתע לפתע לפתע adverb unspecified unspecified unspecified unspecified unspecified  	O	null
23 . . . punctuation unspecified unspecified unspecified unspecified unspecified  	O	null

0 ב ב בים preposition unspecified unspecified unspecified unspecified unspecified 0 
0 ים ים בים properName unspecified unspecified unspecified unspecified unspecified  	I_PERS	null
1 ה ה המדבר... definiteArticle unspecified unspecified unspecified unspecified unspecified 0 
1 המדבר... המדבר... המדבר... participle masculine plural absolute any unspecified  	O	null

0 " " " punctuation unspecified unspecified unspecified unspecified unspecified  	O	null
1 הרגת הרג הרגת verb feminine singular unspecified 2 past  	O	null
2 את את את at-preposition unspecified unspecified unspecified unspecified unspecified  	O	null
3 ג'וני ג'וני ג'וני properName unspecified unspecified unspecified unspecified unspecified  	I_PERS	null
4 אחי אחי אחי properName unspecified unspecified unspecified unspecified unspecified  	I_PERS	null
5 , , , punctuation unspecified unspecified unspecified unspecified unspecified  	O	null
6 שיחקתם שיחק שיחקתם verb masculine plural unspecified 2 past  	O	null
7 קלפים קלף קלפים noun masculine plural absolute unspecified unspecified  	O	null
8 עד עד עד preposition unspecified unspecified unspecified unspecified unspecified  	O	null
9 ה ה הבוקר definiteArticle unspecified unspecified unspecified unspecified unspecified 0 
9 הבוקר בוקר הבוקר noun masculine singular absolute unspecified unspecified  	O	null
10 . . . punctuation unspecified unspecified unspecified unspecified unspecified  	O	null

0 ירית ירייה ירית noun feminine singular construct unspecified unspecified  	O	null
1 כדור כדור כדור noun masculine singular absolute unspecified unspecified  	O	null
2 אכזרי אכזרי אכזרי adjective masculine singular absolute unspecified unspecified  	O	null
3 מפני מפני מפני conjunction unspecified unspecified unspecified unspecified unspecified  	O	null
4 ש ש שניצח relativizer/subordinatingConjunction unspecified unspecified unspecified unspecified unspecified 0 
4 ניצח ניצח שניצח verb masculine singular unspecified 3 past  	O	null
5 ב ב בפוקר preposition unspecified unspecified unspecified unspecified unspecified 0 
5 פוקר פוקר בפוקר properName unspecified unspecified unspecified unspecified unspecified  	I_LOC	null
6 . . . punctuation unspecified unspecified unspecified unspecified unspecified  	O	null

0 שלף שלף שלף properName masculine singular unspecified unspecified unspecified  	I_PERS	null
1 ה ה המשופם definiteArticle unspecified unspecified unspecified unspecified unspecified 0 
1 המשופם משופם המשופם adjective masculine singular absolute unspecified unspecified  	O	null
2 אקדח אקדח אקדחו noun masculine singular absolute unspecified unspecified  
2 ו ו אקדחו possessive masculine singular unspecified 3 unspecified 0 	O	null
3 כמו כמו כמו preposition unspecified unspecified unspecified unspecified unspecified  	O	null
4 ברק ברק ברק properName unspecified unspecified unspecified unspecified unspecified  	I_PERS	null
5 , , , punctuation unspecified unspecified unspecified unspecified unspecified  	O	null
6 אך אך אך conjunction unspecified unspecified unspecified unspecified unspecified  	O	null
7 בילי בילי בילי properName unspecified unspecified unspecified unspecified unspecified  	I_PERS	null
8 הקדים הקדים הקדים verb masculine singular unspecified 3 past  	O	null
9 על על על preposition unspecified unspecified unspecified unspecified unspecified  	O	null
10 ה ה ההדק definiteArticle unspecified unspecified unspecified unspecified unspecified 0 
10 ההדק הדק ההדק noun masculine singular absolute unspecified unspecified  	O	null
11 . . . punctuation unspecified unspecified unspecified unspecified unspecified  	O	null

0 נפל נפל נפל verb masculine singular unspecified 3 past  	O	null
1 ה ה המשופם definiteArticle unspecified unspecified unspecified unspecified unspecified 0 
1 המשופם משופם המשופם adjective masculine singular absolute unspecified unspecified  	O	null
2 מתפתל התפתל מתפתל verb masculine singular unspecified any beinoni  	O	null
3 ב ב באבק preposition unspecified unspecified unspecified unspecified unspecified 0 
3 אבק אבק באבק noun masculine singular absolute unspecified unspecified  	O	null
4 , , , punctuation unspecified unspecified unspecified unspecified unspecified  	O	null
5 חברי חבר חבריו noun masculine plural absolute unspecified unspecified  
5 ו ו חבריו possessive masculine singular unspecified 3 unspecified 0 	O	null
6 ברחו ברח ברחו verb masculine-and-feminine plural unspecified 3 past  	O	null
7 ו ו ובצדק conjunction unspecified unspecified unspecified unspecified unspecified 0 
7 ב ב ובצדק preposition unspecified unspecified unspecified unspecified unspecified 0 
7 ה ה ובצדק definiteArticle unspecified unspecified unspecified unspecified unspecified 0 
7 הצדק צדק ובצדק noun masculine singular absolute unspecified unspecified  	O	null
8 . . . punctuation unspecified unspecified unspecified unspecified unspecified  	O	null

0 ב ב בים preposition unspecified unspecified unspecified unspecified unspecified 0 
0 ים ים בים properName unspecified unspecified unspecified unspecified unspecified  	I_PERS	null
1 ה ה המדבר... definiteArticle unspecified unspecified unspecified unspecified unspecified 0 
1 המדבר... המדבר... המדבר... participle masculine plural absolute any unspecified  	O	null

0 כולם כולם כולם pronoun masculine plural unspecified 3 unspecified  	O	null
1 התאספו התאסף התאספו verb masculine-and-feminine plural unspecified 3 past  	O	null
2 מסביב מסביב מסביב adverb unspecified unspecified unspecified unspecified unspecified  	O	null
3 ו ו ובילי conjunction unspecified unspecified unspecified unspecified unspecified 0 
3 בילי בילי ובילי properName unspecified unspecified unspecified unspecified unspecified  	I_PERS	null
4 פנה פנה פנה verb masculine singular unspecified 3 past  	O	null
5 אל אל אל preposition unspecified unspecified unspecified unspecified unspecified  	O	null
6 ה ה השריף definiteArticle unspecified unspecified unspecified unspecified unspecified 0 
6 השריף שריף השריף noun masculine singular absolute unspecified unspecified  	O	null
7 " " " punctuation unspecified unspecified unspecified unspecified unspecified  	O	null
8 איש איש איש noun masculine singular absolute unspecified unspecified  	O	null
9 זה זה זה pronoun masculine singular unspecified 3 unspecified  	O	null
10 לא לא לא negation unspecified unspecified unspecified unspecified unspecified  	O	null
11 ידע ידע ידע verb masculine singular unspecified 3 past  	O	null
12 ש ש שאחיו relativizer/subordinatingConjunction unspecified unspecified unspecified unspecified unspecified 0 
12 אחי אח שאחיו noun masculine plural absolute unspecified unspecified  
12 ו ו שאחיו possessive masculine singular unspecified 3 unspecified 0 	O	null
13 החביא החביא החביא preposition unspecified unspecified unspecified unspecified unspecified  	O	null
14 צמד צמד צמד noun masculine singular construct unspecified unspecified  	O	null
15 אסים אס אסים noun masculine plural absolute unspecified unspecified  	O	null
16 ב ב בגרב preposition unspecified unspecified unspecified unspecified unspecified 0 
16 גרב גרב בגרב noun masculine singular absolute unspecified unspecified  	O	null
17 . . . punctuation unspecified unspecified unspecified unspecified unspecified  	O	null

0 עלה עלה עלה verb masculine singular unspecified 3 past  	O	null
1 בילי בילי בילי properName unspecified unspecified unspecified unspecified unspecified  	I_PERS	null
2 ב ב בוי preposition unspecified unspecified unspecified unspecified unspecified 0 
2 וי וי בוי properName unspecified unspecified unspecified unspecified unspecified  	I_PERS	null
3 על על על preposition unspecified unspecified unspecified unspecified unspecified  	O	null
4 סוס סוס סוסו noun masculine singular absolute unspecified unspecified  
4 ו ו סוסו possessive masculine singular unspecified 3 unspecified 0 	O	null
5 ה ה הלבן definiteArticle unspecified unspecified unspecified unspecified unspecified 0 
5 הלבן לבן הלבן adjective masculine singular absolute unspecified unspecified  	O	null
6 זקוף זקף זקוף verb masculine singular unspecified 2 imperative  	O	null
7 , , , punctuation unspecified unspecified unspecified unspecified unspecified  	O	null
8 מיוזע מיוזע מיוזע properName unspecified unspecified unspecified unspecified unspecified  	I_PERS	null
9 ו ו וקשוח conjunction unspecified unspecified unspecified unspecified unspecified 0 
9 קשוח קשוח וקשוח adjective masculine singular absolute unspecified unspecified  	O	null
10 . . . punctuation unspecified unspecified unspecified unspecified unspecified  	O	null

0 ניתר ניתר ניתר verb masculine singular unspecified 3 past  	O	null
1 ב ב בסיגנון preposition unspecified unspecified unspecified unspecified unspecified 0 
1 ה ה בסיגנון definiteArticle unspecified unspecified unspecified unspecified unspecified 0 
1 הסיגנון סגנון בסיגנון noun masculine singular absolute unspecified unspecified  	O	null
2 ה ה הראוי definiteArticle unspecified unspecified unspecified unspecified unspecified 0 
2 הראוי ראוי הראוי adjective masculine singular absolute unspecified unspecified  	O	null
3 ל ל לקלפן preposition unspecified unspecified unspecified unspecified unspecified 0 
3 קלף קלף לקלפן noun masculine singular absolute unspecified unspecified  
3 ן ן לקלפן possessive feminine plural unspecified 3 unspecified 0 	O	null
4 ו ו וכמו conjunction unspecified unspecified unspecified unspecified unspecified 0 
4 כמו כמו וכמו preposition unspecified unspecified unspecified unspecified unspecified  	O	null
5 אגדה אגדה אגדה noun feminine singular absolute unspecified unspecified  	O	null
6 נעלם נעלם נעלם verb masculine singular unspecified 3 past  	O	null
7 ב ב ברוח preposition unspecified unspecified unspecified unspecified unspecified 0 
7 רוח רוח ברוח noun feminine singular absolute unspecified unspecified  	O	null
8 . . . punctuation unspecified unspecified unspecified unspecified unspecified  	O	null

