0 איזה איזה איזה quantifier unspecified unspecified construct unspecified unspecified  	O	null
1 קסם קסם קסם noun masculine singular absolute unspecified unspecified  	O	null
2 משוגע משוגע משוגע adjective masculine singular absolute unspecified unspecified  	O	null
3 איך איך איך adverb unspecified unspecified unspecified unspecified unspecified  	O	null
4 אני הוא אני pronoun masculine-and-feminine singular unspecified 1 unspecified  	O	null
5 רוצה רצה רוצה verb masculine singular unspecified any beinoni  	O	null
6 את את אותך at-preposition unspecified unspecified unspecified unspecified unspecified  
6 ך ך אותך pronomial masculine singular unspecified 2 unspecified 0 	O	null
7 מסדר סידר מסדר verb masculine singular unspecified any beinoni  	O	null
8 ו ו ומתפרק conjunction unspecified unspecified unspecified unspecified unspecified 0 
8 מתפרק התפרק ומתפרק verb masculine singular unspecified any beinoni  	O	null
9 נעלם נעלם נעלם adjective masculine singular absolute unspecified unspecified  	O	null
10 ו ו ומתקרב conjunction unspecified unspecified unspecified unspecified unspecified 0 
10 מתקרב התקרב ומתקרב verb masculine singular unspecified any beinoni  	O	null
11 כמו כמו כמו preposition unspecified unspecified unspecified unspecified unspecified  	O	null
12 חלום חלום חלום noun masculine singular absolute unspecified unspecified  	O	null
13 ש ש שמתגשם relativizer/subordinatingConjunction unspecified unspecified unspecified unspecified unspecified 0 
13 מתגשם התגשם שמתגשם verb masculine singular unspecified any beinoni  	O	null
14 אמיתי אמיתי אמיתי properName unspecified unspecified unspecified unspecified unspecified  	I_PERS	null
15 ו ו ומתנשם conjunction unspecified unspecified unspecified unspecified unspecified 0 
15 מתנשם התנשם ומתנשם verb masculine singular unspecified any beinoni  	O	null
16 מרחף ריחף מרחף verb masculine singular unspecified any beinoni  	O	null
17 על על על preposition unspecified unspecified unspecified unspecified unspecified  	O	null
18 פני פני פני noun masculine singular absolute unspecified unspecified  	O	null
19 גופי גוף גופי noun masculine plural construct unspecified unspecified  	O	null
20 מרגש מרגש מרגש adjective masculine singular absolute unspecified unspecified  	O	null
21 ו ו ואמיתי conjunction unspecified unspecified unspecified unspecified unspecified 0 
21 אמיתי אמיתי ואמיתי adjective masculine singular absolute unspecified unspecified  	O	null

0 אם אם אם conjunction unspecified unspecified unspecified unspecified unspecified  	O	null
1 אני הוא אני pronoun masculine-and-feminine singular unspecified 1 unspecified  	O	null
2 של של שלך shel-preposition unspecified unspecified unspecified unspecified unspecified  
2 ך ך שלך pronomial feminine singular unspecified 2 unspecified 0 	O	null
3 קח לקח קח verb masculine singular unspecified 2 imperative  	O	null
4 את את אותי at-preposition unspecified unspecified unspecified unspecified unspecified  
4 י י אותי pronomial masculine-and-feminine singular unspecified 1 unspecified 0 	O	null
5 את את איתך at-preposition unspecified unspecified unspecified unspecified unspecified  
5 ך ך איתך pronomial feminine singular unspecified 2 unspecified 0 	O	null
6 ל ל לשמיים preposition unspecified unspecified unspecified unspecified unspecified 0 
6 ה ה לשמיים definiteArticle unspecified unspecified unspecified unspecified unspecified 0 
6 השמיים שמיים לשמיים noun masculine plural absolute unspecified unspecified  	O	null
7 מעל מעל מעל preposition unspecified unspecified unspecified unspecified unspecified  	O	null
8 אם אם אם conjunction unspecified unspecified unspecified unspecified unspecified  	O	null
9 אתה הוא אתה pronoun masculine singular unspecified 2 unspecified  	O	null
10 של של שלי shel-preposition unspecified unspecified unspecified unspecified unspecified  
10 י י שלי pronomial masculine-and-feminine singular unspecified 1 unspecified 0 	O	null
11 בוא בא בוא verb masculine singular unspecified 2 imperative  	O	null
12 גלה גל גלה verb feminine singular unspecified 3 past  	O	null
13 את את איתי at-preposition unspecified unspecified unspecified unspecified unspecified  
13 י י איתי pronomial masculine-and-feminine singular unspecified 1 unspecified 0 	O	null
14 מ מ מיסתורין preposition unspecified unspecified unspecified unspecified unspecified 0 
14 יסתורין יסתורין מיסתורין noun masculine singular construct unspecified unspecified  	O	null
15 ש ש ששמו relativizer/subordinatingConjunction unspecified unspecified unspecified unspecified unspecified 0 
15 שם שם ששמו participle masculine singular unspecified any unspecified  
15 ו ו ששמו possessive masculine singular unspecified 3 unspecified 0 	I_ORG	null
16 א א א properName unspecified unspecified unspecified unspecified unspecified  	I_ORG	null
17 - - - properName unspecified unspecified unspecified unspecified unspecified  	I_ORG	null
18 ה ה ה properName unspecified unspecified unspecified unspecified unspecified  	I_ORG	null
19 - - - punctuation unspecified unspecified unspecified unspecified unspecified  	O	null
20 ב ב ב preposition unspecified unspecified unspecified unspecified unspecified 0 	O	null
21 - - - punctuation unspecified unspecified unspecified unspecified unspecified  	O	null
22 ה ה ה definiteArticle unspecified unspecified unspecified unspecified unspecified 0 	O	null
23 אם אם אם conjunction unspecified unspecified unspecified unspecified unspecified  	O	null
24 אני הוא אני pronoun masculine-and-feminine singular unspecified 1 unspecified  	O	null
25 של של שלך shel-preposition unspecified unspecified unspecified unspecified unspecified  
25 ך ך שלך pronomial feminine singular unspecified 2 unspecified 0 	O	null
26 קח לקח קח verb masculine singular unspecified 2 imperative  	O	null
27 את את אותי at-preposition unspecified unspecified unspecified unspecified unspecified  
27 י י אותי pronomial masculine-and-feminine singular unspecified 1 unspecified 0 	O	null
28 את את איתך at-preposition unspecified unspecified unspecified unspecified unspecified  
28 ך ך איתך pronomial feminine singular unspecified 2 unspecified 0 	O	null
29 ל ל לשמיים preposition unspecified unspecified unspecified unspecified unspecified 0 
29 ה ה לשמיים definiteArticle unspecified unspecified unspecified unspecified unspecified 0 
29 השמיים שמיים לשמיים noun masculine plural absolute unspecified unspecified  	O	null
30 מעל מעל מעל preposition unspecified unspecified unspecified unspecified unspecified  	O	null
31 אם אם אם conjunction unspecified unspecified unspecified unspecified unspecified  	O	null
32 אתה הוא אתה pronoun masculine singular unspecified 2 unspecified  	O	null
33 של של שלי shel-preposition unspecified unspecified unspecified unspecified unspecified  
33 י י שלי pronomial masculine-and-feminine singular unspecified 1 unspecified 0 	O	null
34 בוא בא בוא verb masculine singular unspecified 2 imperative  	O	null
35 גלה גל גלה verb feminine singular unspecified 3 past  	O	null
36 את את איתי at-preposition unspecified unspecified unspecified unspecified unspecified  
36 י י איתי pronomial masculine-and-feminine singular unspecified 1 unspecified 0 	O	null
37 מ מ מיסתורין preposition unspecified unspecified unspecified unspecified unspecified 0 
37 יסתורין יסתורין מיסתורין noun masculine singular construct unspecified unspecified  	O	null
38 ש ש ששמו relativizer/subordinatingConjunction unspecified unspecified unspecified unspecified unspecified 0 
38 שם שם ששמו participle masculine singular unspecified any unspecified  
38 ו ו ששמו possessive masculine singular unspecified 3 unspecified 0 	I_ORG	null
39 א א א properName unspecified unspecified unspecified unspecified unspecified  	I_ORG	null
40 - - - properName unspecified unspecified unspecified unspecified unspecified  	I_ORG	null
41 ה ה ה properName unspecified unspecified unspecified unspecified unspecified  	I_ORG	null
42 - - - punctuation unspecified unspecified unspecified unspecified unspecified  	O	null
43 ב ב ב preposition unspecified unspecified unspecified unspecified unspecified 0 	O	null
44 - - - punctuation unspecified unspecified unspecified unspecified unspecified  	O	null
45 ה ה ה definiteArticle unspecified unspecified unspecified unspecified unspecified 0 	O	null
46 יה יה יה properName unspecified unspecified unspecified unspecified unspecified  	I_PERS	null
47 יה יה יה properName unspecified unspecified unspecified unspecified unspecified  	I_PERS	null
48 יה יה יה properName unspecified unspecified unspecified unspecified unspecified  	I_PERS	null
49 יה יה יה properName unspecified unspecified unspecified unspecified unspecified  	I_PERS	null
50 יה יה יה properName unspecified unspecified unspecified unspecified unspecified  	I_PERS	null
51 יה יה יה properName unspecified unspecified unspecified unspecified unspecified  	I_PERS	null
52 יה יה יה properName unspecified unspecified unspecified unspecified unspecified  	I_PERS	null
53 יה יה יה properName unspecified unspecified unspecified unspecified unspecified  	I_PERS	null
54 יה יה יה properName unspecified unspecified unspecified unspecified unspecified  	I_PERS	null
55 יה יה יה properName unspecified unspecified unspecified unspecified unspecified  	I_PERS	null
56 יה יה יה properName unspecified unspecified unspecified unspecified unspecified  	I_PERS	null
57 יה יה יה properName unspecified unspecified unspecified unspecified unspecified  	I_PERS	null
58 יה יה יה properName unspecified unspecified unspecified unspecified unspecified  	I_PERS	null
59 יה יה יה properName unspecified unspecified unspecified unspecified unspecified  	I_PERS	null
60 יה יה יה properName unspecified unspecified unspecified unspecified unspecified  	I_PERS	null
61 יה יה יה properName unspecified unspecified unspecified unspecified unspecified  	I_PERS	null
62 מ מ מיסתורין preposition unspecified unspecified unspecified unspecified unspecified 0 
62 יסתורין יסתורין מיסתורין noun masculine singular construct unspecified unspecified  	O	null
63 ש ש ששמו relativizer/subordinatingConjunction unspecified unspecified unspecified unspecified unspecified 0 
63 שם שם ששמו participle masculine singular unspecified any unspecified  
63 ו ו ששמו possessive masculine singular unspecified 3 unspecified 0 	I_ORG	null
64 א א א properName unspecified unspecified unspecified unspecified unspecified  	I_ORG	null
65 - - - properName unspecified unspecified unspecified unspecified unspecified  	I_ORG	null
66 ה ה ה properName unspecified unspecified unspecified unspecified unspecified  	I_ORG	null
67 - - - punctuation unspecified unspecified unspecified unspecified unspecified  	O	null
68 ב ב ב preposition unspecified unspecified unspecified unspecified unspecified 0 	O	null
69 - - - punctuation unspecified unspecified unspecified unspecified unspecified  	O	null
70 ה ה ה definiteArticle unspecified unspecified unspecified unspecified unspecified 0 	O	null

0 ש ש שאתה relativizer/subordinatingConjunction unspecified unspecified unspecified unspecified unspecified 0 
0 אתה הוא שאתה pronoun masculine singular unspecified 2 unspecified  	O	null
1 כאן כאן כאן adverb unspecified unspecified unspecified unspecified unspecified  	O	null
2 לצד לצד לצידי preposition unspecified unspecified unspecified unspecified unspecified  
2 י י לצידי pronomial masculine-and-feminine singular unspecified 1 unspecified 0 	O	null
3 מרחף ריחף מרחף verb masculine singular unspecified any beinoni  	O	null
4 וחולמני וחולמני וחולמני verb unspecified unspecified unspecified unspecified infinitive  	O	null
5 איך איך איך adverb unspecified unspecified unspecified unspecified unspecified  	O	null
6 את את איתך at-preposition unspecified unspecified unspecified unspecified unspecified  
6 ך ך איתך pronomial masculine singular unspecified 2 unspecified 0 	O	null
7 הכל הכיל הכל verb masculine singular unspecified 2 imperative  	O	null
8 אחר אחר אחר adjective masculine singular absolute unspecified unspecified  	O	null
9 איך איך איך adverb unspecified unspecified unspecified unspecified unspecified  	O	null
10 ה ה האושר definiteArticle unspecified unspecified unspecified unspecified unspecified 0 
10 האושר אושר האושר noun masculine singular absolute unspecified unspecified  	O	null
11 מתבהר התבהר מתבהר verb masculine singular unspecified any beinoni  	O	null
12 ה ה הימים definiteArticle unspecified unspecified unspecified unspecified unspecified 0 
12 הימים יום הימים noun masculine plural absolute unspecified unspecified  	O	null
13 אינם הוא אינם copula masculine plural unspecified 3 beinoni  	O	null
14 עוברים עבר עוברים verb masculine plural unspecified any beinoni  	O	null
15 ה ה הלילות definiteArticle unspecified unspecified unspecified unspecified unspecified 0 
15 הלילות לילה הלילות noun masculine plural absolute unspecified unspecified  	O	null
16 לא לא לא negation unspecified unspecified unspecified unspecified unspecified  	O	null
17 נגמרים נגמר נגמרים verb masculine plural unspecified any beinoni  	O	null
18 יש יש יש existential unspecified unspecified unspecified unspecified unspecified  	O	null
19 ב ב בי preposition unspecified unspecified unspecified unspecified unspecified  
19 י י בי pronomial masculine-and-feminine singular unspecified 1 unspecified 0 	O	null
20 קסם קסם קסם noun masculine singular absolute unspecified unspecified  	O	null
21 ב ב באוויר preposition unspecified unspecified unspecified unspecified unspecified 0 
21 ה ה באוויר definiteArticle unspecified unspecified unspecified unspecified unspecified 0 
21 האוויר אוויר באוויר noun masculine singular absolute unspecified unspecified  	O	null
22 קצת קצת קצת adverb unspecified unspecified unspecified unspecified unspecified  	O	null
23 מכאיב הכאיב מכאיב verb masculine singular unspecified any beinoni  	O	null
24 ו ו וקצת conjunction unspecified unspecified unspecified unspecified unspecified 0 
24 קצת קצת וקצת adverb unspecified unspecified unspecified unspecified unspecified  	O	null
25 שביר שביר שביר adjective masculine singular absolute unspecified unspecified  	O	null

0 אם אם אם conjunction unspecified unspecified unspecified unspecified unspecified  	O	null
1 אני הוא אני pronoun masculine-and-feminine singular unspecified 1 unspecified  	O	null
2 ש ש שלך... relativizer/subordinatingConjunction unspecified unspecified unspecified unspecified unspecified 0 
2 ל ל שלך... preposition unspecified unspecified unspecified unspecified unspecified 0 
2 כ כ שלך... adverb unspecified unspecified unspecified unspecified unspecified 0 
2 ... ... שלך... punctuation unspecified unspecified unspecified unspecified unspecified  	O	null

