0 בַּלַּיְלָה בַּלַּיְלָה בַּלַּיְלָה verb masculine singular unspecified 3 future  	O	null
1 ב ב בָּא preposition unspecified unspecified unspecified unspecified unspecified 0 
1 ָּ ָּ בָּא noun masculine singular absolute unspecified unspecified  
1 ו ו בָּא possessive masculine singular unspecified 3 unspecified 0 	O	null
2 הַמְבַשֵּׂר הַמְבַשֵּׂר הַמְבַשֵּׂר adjective masculine singular construct unspecified unspecified  	O	null
3 עַל עַל עַל properName unspecified unspecified unspecified unspecified unspecified  	I_PERS	null
4 מִשְׁכָּבִי מִשְׁכָּבִי מִשְׁכָּבִי properName unspecified unspecified unspecified unspecified unspecified  	I_PERS	null
5 יָשַׁב יָשַׁב יָשַׁב properName unspecified unspecified unspecified unspecified unspecified  	I_PERS	null
6 , , , punctuation unspecified unspecified unspecified unspecified unspecified  	O	null
7 בָּלְטו בָּלְטו בָּלְטו properName unspecified unspecified unspecified unspecified unspecified  	I_PERS	null
8 ּ ּ ּ punctuation unspecified unspecified unspecified unspecified unspecified  	O	null
9 עַצְמוֹת עַצְמוֹת עַצְמוֹת verb feminine singular unspecified 2 imperative  	O	null
10 גֵּוו גֵּוו גֵּוו noun feminine plural absolute unspecified unspecified  	O	null
11 ֹ ֹ ֹ punctuation unspecified unspecified unspecified unspecified unspecified  	O	null
12 אֵין אֵין אֵין properName unspecified unspecified unspecified unspecified unspecified  	I_ORG	null
13 - - - punctuation unspecified unspecified unspecified unspecified unspecified  	O	null
14 ש ש שְׁאֵר relativizer/subordinatingConjunction unspecified unspecified unspecified unspecified unspecified 0 
14 ְׁאֵר ְׁאֵר שְׁאֵר properName unspecified unspecified unspecified unspecified unspecified  	I_ORG	null
15 , , , punctuation unspecified unspecified unspecified unspecified unspecified  	O	null
16 עָמְקו עָמְקו עָמְקו properName unspecified unspecified unspecified unspecified unspecified  	I_PERS	null
17 ּ ּ ּ punctuation unspecified unspecified unspecified unspecified unspecified  	O	null
18 חוֹרֵי חוֹרֵי חוֹרֵי properName unspecified unspecified unspecified unspecified unspecified  	I_PERS	null
19 עֵינָיו עֵינָיו עֵינָיו properName unspecified unspecified unspecified unspecified unspecified  	I_PERS	null
20 . . . punctuation unspecified unspecified unspecified unspecified unspecified  	O	null

0 אֲזַי אֲזַי אֲזַי properName unspecified unspecified unspecified unspecified unspecified  	I_PERS	null
1 יָדַעְתִּי יָדַעְתִּי יָדַעְתִּי properName unspecified unspecified unspecified unspecified unspecified  	I_PERS	null
2 כִּי כִּי כִּי properName unspecified unspecified unspecified unspecified unspecified  	I_PERS	null
3 נִשְׁבַּר נִשְׁבַּר נִשְׁבַּר properName unspecified unspecified unspecified unspecified unspecified  	I_PERS	null
4 הַגֶּשֶׁר הַגֶּשֶׁר הַגֶּשֶׁר properName unspecified unspecified unspecified unspecified unspecified  	I_PERS	null
5 הַיָּשָׁן הַיָּשָׁן הַיָּשָׁן properName unspecified unspecified unspecified unspecified unspecified  	I_PERS	null
6 , , , punctuation unspecified unspecified unspecified unspecified unspecified  	O	null
7 שֶׁבֵּין שֶׁבֵּין שֶׁבֵּין properName unspecified unspecified unspecified unspecified unspecified  	I_PERS	null
8 אֶתְמוֹל אֶתְמוֹל אֶתְמוֹל properName unspecified unspecified unspecified unspecified unspecified  	I_PERS	null
9 לְבֵין לְבֵין לְבֵין properName unspecified unspecified unspecified unspecified unspecified  	I_PERS	null
10 מָחָר מָחָר מָחָר properName unspecified unspecified unspecified unspecified unspecified  	I_PERS	null
11 תָּלו תָּלו תָּלו verb masculine-and-feminine plural unspecified 2 future  	O	null
12 ּ ּ ּ punctuation unspecified unspecified unspecified unspecified unspecified  	O	null
13 יְדֵי יְדֵי יְדֵי properName unspecified unspecified unspecified unspecified unspecified  	I_PERS	null
14 הַזְּמָן הַזְּמָן הַזְּמָן properName unspecified unspecified unspecified unspecified unspecified  	I_PERS	null
15 . . . punctuation unspecified unspecified unspecified unspecified unspecified  	O	null

0 אִיֵּם אִיֵּם אִיֵּם properName unspecified unspecified unspecified unspecified unspecified  	I_PERS	null
1 עָלַי עָלַי עָלַי properName unspecified unspecified unspecified unspecified unspecified  	I_PERS	null
2 אֶגְרוֹף אֶגְרוֹף אֶגְרוֹף properName unspecified unspecified unspecified unspecified unspecified  	I_PERS	null
3 רָזֶה רָזֶה רָזֶה properName unspecified unspecified unspecified unspecified unspecified  	I_PERS	null
4 , , , punctuation unspecified unspecified unspecified unspecified unspecified  	O	null
5 נִשְׁמַע נִשְׁמַע נִשְׁמַע adjective masculine singular construct unspecified unspecified  	O	null
6 ל ל לִי preposition unspecified unspecified unspecified unspecified unspecified 0 
6 ִי ִי לִי properName unspecified unspecified unspecified unspecified unspecified  	I_LOC	null
7 צְחוֹק צְחוֹק צְחוֹק properName unspecified unspecified unspecified unspecified unspecified  	I_PERS	null
8 זָדוֹן זָדוֹן זָדוֹן properName unspecified unspecified unspecified unspecified unspecified  	I_PERS	null
9 : : : punctuation unspecified unspecified unspecified unspecified unspecified  	O	null
10 אָכֵן אָכֵן אָכֵן properName unspecified unspecified unspecified unspecified unspecified  	I_PERS	null
11 יְהֵא יְהֵא יְהֵא verb masculine singular unspecified 3 future  	O	null
12 ה ה הַשִּׁיר definiteArticle unspecified unspecified unspecified unspecified unspecified 0 
12 הַשִּׁיר הַשִּׁיר הַשִּׁיר noun masculine singular absolute unspecified unspecified  	O	null
13 הַזֶה הַזֶה הַזֶה verb masculine-and-feminine singular unspecified 1 future  	O	null
14 ש ש שִׁירֵך relativizer/subordinatingConjunction unspecified unspecified unspecified unspecified unspecified 0 
14 ִׁירֵך ִׁירֵך שִׁירֵך properName unspecified unspecified unspecified unspecified unspecified  	I_PERS	null
15 ְ ְ ְ punctuation unspecified unspecified unspecified unspecified unspecified  	O	null
16 הָאַחֲרוֹן הָאַחֲרוֹן הָאַחֲרוֹן verb masculine singular unspecified 2 imperative  	O	null
17 ! ! ! punctuation unspecified unspecified unspecified unspecified unspecified  	O	null

