0 ב ב בגואטמאלה preposition unspecified unspecified unspecified unspecified unspecified 0 
0 גואטמאלה גואטמאלה בגואטמאלה properName unspecified unspecified unspecified unspecified unspecified  	I_LOC	null
1 ה ה הציפורים definiteArticle unspecified unspecified unspecified unspecified unspecified 0 
1 הציפורים ציפור הציפורים noun masculine plural absolute unspecified unspecified  	O	null
2 עפות עף עפות verb feminine plural unspecified any beinoni  	O	null
3 לאחור לאחור לאחור adverb unspecified unspecified unspecified unspecified unspecified  	O	null
4 ו ו ושורר conjunction unspecified unspecified unspecified unspecified unspecified 0 
4 שורר שורר ושורר verb masculine singular unspecified 3 past  	O	null
5 שם שם שם adverb unspecified unspecified unspecified unspecified unspecified  	O	null
6 רעב רעב רעב noun masculine singular absolute unspecified unspecified  	O	null
7 בטאשקנט בטאשקנט בטאשקנט properName unspecified unspecified unspecified unspecified unspecified  	O	null
8 יש יש יש existential unspecified unspecified unspecified unspecified unspecified  	O	null
9 שבט שבט שבט noun masculine singular absolute unspecified unspecified  	O	null
10 של של של shel-preposition unspecified unspecified unspecified unspecified unspecified  	O	null
11 נשים איש נשים noun feminine plural absolute unspecified unspecified  	O	null
12 עם עם עם preposition unspecified unspecified unspecified unspecified unspecified  	O	null
13 שפם שפם שפם noun masculine singular absolute unspecified unspecified  	O	null
14 ו ו ושיני conjunction unspecified unspecified unspecified unspecified unspecified 0 
14 שיני שן ושיני noun feminine plural construct unspecified unspecified  	O	null
15 זהב זהב זהב noun masculine singular absolute unspecified unspecified  	O	null
16 ב ב בהודו preposition unspecified unspecified unspecified unspecified unspecified 0 
16 הודו הודו בהודו properName unspecified unspecified unspecified unspecified unspecified  	I_LOC	null
17 יש יש יש existential unspecified unspecified unspecified unspecified unspecified  	O	null
18 נהר נהר נהר noun masculine singular absolute unspecified unspecified  	O	null
19 ה ה הזורם definiteArticle unspecified unspecified unspecified unspecified unspecified 0 
19 הזורם זרם הזורם participle masculine singular absolute any unspecified  	O	null
20 הפוך הפוך הפוך adjective masculine singular absolute unspecified unspecified  	O	null
21 ב ב במעלה preposition unspecified unspecified unspecified unspecified unspecified 0 
21 מעלה מעלה במעלה noun masculine singular construct unspecified unspecified  	O	null
22 ה ה ההר definiteArticle unspecified unspecified unspecified unspecified unspecified 0 
22 ההר הר ההר noun masculine singular absolute unspecified unspecified  	O	null
23 ב ב באיטליה preposition unspecified unspecified unspecified unspecified unspecified 0 
23 איטליה איטליה באיטליה properName unspecified unspecified unspecified unspecified unspecified  	I_LOC	null
24 יש יש יש existential unspecified unspecified unspecified unspecified unspecified  	O	null
25 נשים איש נשים noun feminine plural absolute unspecified unspecified  	O	null
26 ה ה המוכרות definiteArticle unspecified unspecified unspecified unspecified unspecified 0 
26 המוכרות מכר המוכרות participle feminine plural absolute any unspecified  	O	null
27 את את את at-preposition unspecified unspecified unspecified unspecified unspecified  	O	null
28 גוף גוף גופן noun masculine singular absolute unspecified unspecified  
28 ן ן גופן possessive feminine plural unspecified 3 unspecified 0 	O	null
29 כדי כדי כדי conjunction unspecified unspecified unspecified unspecified unspecified  	O	null
30 להתקבל התקבל להתקבל verb unspecified unspecified unspecified unspecified infinitive  	O	null
31 ל ל למנזר preposition unspecified unspecified unspecified unspecified unspecified 0 
31 מנזר מנזר למנזר noun masculine singular construct unspecified unspecified  	O	null
32 תה תה תה noun masculine singular absolute unspecified unspecified  	O	null
33 ו ו ואורז conjunction unspecified unspecified unspecified unspecified unspecified 0 
33 אורז אורז ואורז noun masculine singular absolute unspecified unspecified  	O	null
34 יש יש יש existential unspecified unspecified unspecified unspecified unspecified  	O	null
35 ב ב בסין preposition unspecified unspecified unspecified unspecified unspecified 0 
35 סין סין בסין properName unspecified unspecified unspecified unspecified unspecified  	I_LOC	null
36 ו ו ובעזה conjunction unspecified unspecified unspecified unspecified unspecified 0 
36 ב ב ובעזה preposition unspecified unspecified unspecified unspecified unspecified 0 
36 עזה עזה ובעזה properName unspecified unspecified unspecified unspecified unspecified  	B_LOC	null
37 כסא כסא כסא noun masculine singular construct unspecified unspecified  	O	null
38 גלגלים גלגל גלגלים noun masculine plural absolute unspecified unspecified  	O	null
39 שבור שבור שבור adjective masculine singular absolute unspecified unspecified  	O	null
40 של של של shel-preposition unspecified unspecified unspecified unspecified unspecified  	O	null
41 אחמד אחמד אחמד properName unspecified unspecified unspecified unspecified unspecified  	I_PERS	null
42 יאסין יאסין יאסין properName unspecified unspecified unspecified unspecified unspecified  	I_PERS	null
43 ב ב בפולין preposition unspecified unspecified unspecified unspecified unspecified 0 
43 פולין פולין בפולין properName unspecified unspecified unspecified unspecified unspecified  	I_LOC	null
44 פיתחו פיתח פיתחו verb masculine-and-feminine plural unspecified 3 past  	O	null
45 מדענים מדען מדענים noun masculine plural absolute unspecified unspecified  	O	null
46 זן זן זן noun masculine singular absolute unspecified unspecified  	O	null
47 חדש חדש חדש adjective masculine singular absolute unspecified unspecified  	O	null
48 של של של shel-preposition unspecified unspecified unspecified unspecified unspecified  	O	null
49 חיידק חיידק חיידק noun masculine singular absolute unspecified unspecified  	O	null
50 ש ש שגורם relativizer/subordinatingConjunction unspecified unspecified unspecified unspecified unspecified 0 
50 גורם גרם שגורם verb masculine singular unspecified any beinoni  	O	null
51 ל ל לשיתוק preposition unspecified unspecified unspecified unspecified unspecified 0 
51 שיתוק שיתוק לשיתוק noun masculine singular construct unspecified unspecified  	O	null
52 מוחין מוח מוחין noun masculine plural absolute unspecified unspecified  	O	null
53 ב ב באמריקה preposition unspecified unspecified unspecified unspecified unspecified 0 
53 אמריקה אמריקה באמריקה properName unspecified unspecified unspecified unspecified unspecified  	I_LOC	null
54 יש יש יש existential unspecified unspecified unspecified unspecified unspecified  	O	null
55 מכונה מכונה מכונה noun feminine singular absolute unspecified unspecified  	O	null
56 ה ה האוכלת definiteArticle unspecified unspecified unspecified unspecified unspecified 0 
56 האוכלת אכל האוכלת participle feminine singular absolute any unspecified  	O	null
57 מתכת מתכת מתכת noun feminine singular absolute unspecified unspecified  	O	null
58 ו ו ופולטת conjunction unspecified unspecified unspecified unspecified unspecified 0 
58 פולטת פלט ופולטת verb feminine singular unspecified any beinoni  	O	null
59 מטבעות מטבעה מטבעות noun feminine plural absolute unspecified unspecified  	O	null
60 שוטפת שוטף שוטפת adjective feminine singular absolute unspecified unspecified  	O	null
61 ידיים יד ידיים noun feminine plural absolute unspecified unspecified  	O	null
62 מורידה הוריד מורידה verb feminine singular unspecified any beinoni  	O	null
63 את את את at-preposition unspecified unspecified unspecified unspecified unspecified  	O	null
64 ה ה המים definiteArticle unspecified unspecified unspecified unspecified unspecified 0 
64 המים מים המים noun masculine plural absolute unspecified unspecified  	O	null
65 ו ו ומנגבת conjunction unspecified unspecified unspecified unspecified unspecified 0 
65 מנגבת ניגב ומנגבת verb feminine singular unspecified any beinoni  	O	null
66 עם עם עם preposition unspecified unspecified unspecified unspecified unspecified  	O	null
67 שטרות שטר שטרות noun masculine plural absolute unspecified unspecified  	O	null
68 ב ב בנפאל preposition unspecified unspecified unspecified unspecified unspecified 0 
68 נפאל נפאל בנפאל properName unspecified unspecified unspecified unspecified unspecified  	I_LOC	null
69 מגדלים גידל מגדלים properName unspecified unspecified unspecified unspecified unspecified  	I_LOC	null
70 סמים סם סמים noun masculine plural absolute unspecified unspecified  	O	null
71 ו ו ומפריחים conjunction unspecified unspecified unspecified unspecified unspecified 0 
71 מפריחים הפריח ומפריחים verb masculine plural unspecified any beinoni  	O	null
72 את את את at-preposition unspecified unspecified unspecified unspecified unspecified  	O	null
73 ה ה השממה definiteArticle unspecified unspecified unspecified unspecified unspecified 0 
73 השממה שממה השממה noun feminine singular absolute unspecified unspecified  	O	null
74 ב ב בסדום preposition unspecified unspecified unspecified unspecified unspecified 0 
74 סדום סדום בסדום properName masculine singular unspecified unspecified unspecified  	I_LOC	null
75 מלאת מלא מלאת adjective feminine singular construct unspecified unspecified  	O	null
76 ה ה החטאים definiteArticle unspecified unspecified unspecified unspecified unspecified 0 
76 החטאים חטא החטאים noun masculine plural absolute unspecified unspecified  	O	null
77 שוכבים שכב שוכבים verb masculine plural unspecified any beinoni  	O	null
78 עם עם עם preposition unspecified unspecified unspecified unspecified unspecified  	O	null
79 אמא אמא אמא noun feminine singular absolute unspecified unspecified  	O	null
80 אדמה אדמה אדמה noun feminine singular absolute unspecified unspecified  	O	null

0 עולם עולם עולם noun masculine singular absolute unspecified unspecified  	O	null
1 מוזר מוזר מוזר adjective masculine singular absolute unspecified unspecified  	O	null
2 לא לא לא negation unspecified unspecified unspecified unspecified unspecified  	O	null
3 נעצר נעצר נעצר verb masculine singular unspecified 3 past  	O	null
4 מה מה מה interrogative unspecified unspecified unspecified unspecified unspecified  	O	null
5 ש ש שעוד relativizer/subordinatingConjunction unspecified unspecified unspecified unspecified unspecified 0 
5 עוד עוד שעוד adverb unspecified unspecified unspecified unspecified unspecified  	O	null
6 לא לא לא negation unspecified unspecified unspecified unspecified unspecified  	O	null
7 היה הוא היה copula masculine singular unspecified 3 past  	O	null
8 אולי אולי אולי adverb unspecified unspecified unspecified unspecified unspecified  	O	null
9 יהיה הוא יהיה copula masculine singular unspecified 3 future  	O	null
10 מחר מחר מחר adverb unspecified unspecified unspecified unspecified unspecified  	O	null
11 עולם עולם עולם noun masculine singular absolute unspecified unspecified  	O	null
12 מוזר מוזר מוזר adjective masculine singular absolute unspecified unspecified  	O	null
13 אף אף אף conjunction unspecified unspecified unspecified unspecified unspecified  	O	null
14 פעם פעם פעם adverb unspecified unspecified unspecified unspecified unspecified  	O	null
15 לא לא לא negation unspecified unspecified unspecified unspecified unspecified  	O	null
16 נגמר נגמר נגמר verb masculine singular unspecified 3 past  	O	null
17 איזה איזה איזה quantifier unspecified unspecified construct unspecified unspecified  	O	null
18 עולם עולם עולם noun masculine singular absolute unspecified unspecified  	O	null
19 , , , punctuation unspecified unspecified unspecified unspecified unspecified  	O	null
20 עולם עולם עולם noun masculine singular absolute unspecified unspecified  	O	null
21 מוזר מוזר מוזר adjective masculine singular absolute unspecified unspecified  	O	null

0 ב ב בדובאי preposition unspecified unspecified unspecified unspecified unspecified 0 
0 דובאי דובאי בדובאי properName unspecified unspecified unspecified unspecified unspecified  	I_PERS	null
1 גילו גילה גילו verb masculine-and-feminine plural unspecified 3 past  	O	null
2 באר באר באר noun feminine singular construct unspecified unspecified  	O	null
3 נפט נפט נפט noun masculine singular absolute unspecified unspecified  	O	null
4 שני שני שני noun masculine singular construct unspecified unspecified  	I_ORG	null
5 קראט קראט קראט properName unspecified unspecified unspecified unspecified unspecified  	I_ORG	null
6 ה ה הפולטת definiteArticle unspecified unspecified unspecified unspecified unspecified 0 
6 הפולטת פלט הפולטת participle feminine singular absolute any unspecified  	O	null
7 זהב זהב זהב noun masculine singular absolute unspecified unspecified  	O	null
8 שחור שחור שחור adjective masculine singular absolute unspecified unspecified  	O	null
9 ב ב בשבדיה preposition unspecified unspecified unspecified unspecified unspecified 0 
9 שבדיה שוודיה בשבדיה properName unspecified unspecified unspecified unspecified unspecified  	I_LOC	null
10 פיתחו פיתח פיתחו verb masculine-and-feminine plural unspecified 3 past  	O	null
11 אוטובוס אוטובוס אוטובוס noun masculine singular absolute unspecified unspecified  	O	null
12 עמוס עמוס עמוס properName unspecified unspecified unspecified unspecified unspecified  	I_PERS	null
13 ב ב בנוסעים preposition unspecified unspecified unspecified unspecified unspecified 0 
13 ה ה בנוסעים definiteArticle unspecified unspecified unspecified unspecified unspecified 0 
13 הנוסעים נוסע בנוסעים noun masculine plural absolute unspecified unspecified  	O	null
14 ה ה הנוסע definiteArticle unspecified unspecified unspecified unspecified unspecified 0 
14 הנוסע נוסע הנוסע noun masculine singular absolute unspecified unspecified  	O	null
15 לאחור לאחור לאחור adverb unspecified unspecified unspecified unspecified unspecified  	O	null
16 ב ב באיים preposition unspecified unspecified unspecified unspecified unspecified 0 
16 ה ה באיים definiteArticle unspecified unspecified unspecified unspecified unspecified 0 
16 האיים אי באיים noun masculine plural absolute unspecified unspecified  	O	null
17 ה ה הקרביים definiteArticle unspecified unspecified unspecified unspecified unspecified 0 
17 הקרביים קרבי הקרביים adjective masculine plural absolute unspecified unspecified  	O	null
18 יש יש יש existential unspecified unspecified unspecified unspecified unspecified  	O	null
19 סוג סוג סוג noun masculine singular absolute unspecified unspecified  	O	null
20 של של של shel-preposition unspecified unspecified unspecified unspecified unspecified  	O	null
21 קוף קוף קוף properName unspecified unspecified unspecified unspecified unspecified  	I_PERS	null
22 ה ה המשמש definiteArticle unspecified unspecified unspecified unspecified unspecified 0 
22 המשמש שימש המשמש participle masculine singular absolute any unspecified  	O	null
23 כ כ כשוטר preposition unspecified unspecified unspecified unspecified unspecified 0 
23 שוטר שוטר כשוטר noun masculine singular absolute unspecified unspecified  	I_ORG	null
24 מ מ מקוף preposition unspecified unspecified unspecified unspecified unspecified 0 
24 קוף קוף מקוף properName unspecified unspecified unspecified unspecified unspecified  	I_LOC	null
25 ב ב ביפאן preposition unspecified unspecified unspecified unspecified unspecified 0 
25 יפאן יפאן ביפאן properName unspecified unspecified unspecified unspecified unspecified  	I_LOC	null
26 יש יש יש existential unspecified unspecified unspecified unspecified unspecified  	O	null
27 מיקרוגל מיקרוגל מיקרוגל noun masculine singular absolute unspecified unspecified  	O	null
28 ה ה המונע definiteArticle unspecified unspecified unspecified unspecified unspecified 0 
28 המונע מנע המונע participle masculine singular absolute any unspecified  	O	null
29 ב ב בחשמל preposition unspecified unspecified unspecified unspecified unspecified 0 
29 ה ה בחשמל definiteArticle unspecified unspecified unspecified unspecified unspecified 0 
29 החשמל חשמל בחשמל noun masculine singular absolute unspecified unspecified  	O	null
30 ה ה המסוגל definiteArticle unspecified unspecified unspecified unspecified unspecified 0 
30 המסוגל מסוגל המסוגל adjective masculine singular absolute unspecified unspecified  	O	null
31 להקפיא הקפיא להקפיא verb unspecified unspecified unspecified unspecified infinitive  	O	null
32 עוף עוף עוף noun masculine singular absolute unspecified unspecified  	O	null
33 ב ב בארגנטינה preposition unspecified unspecified unspecified unspecified unspecified 0 
33 ארגנטינה ארגנטינה בארגנטינה properName unspecified unspecified unspecified unspecified unspecified  	I_LOC	null
34 בוכים בכה בוכים verb masculine plural unspecified any beinoni  	O	null
35 , , , punctuation unspecified unspecified unspecified unspecified unspecified  	I_LOC	null
36 בריו בריו בריו properName unspecified unspecified unspecified unspecified unspecified  	I_LOC	null
37 דה דה דה properName unspecified unspecified unspecified unspecified unspecified  	I_PERS	null
38 ז'נרו ז'נרו ז'נרו properName unspecified unspecified unspecified unspecified unspecified  	I_PERS	null
39 מתהלכים התהלך מתהלכים verb masculine plural unspecified any beinoni  	O	null
40 מסוממים סומם מסוממים verb masculine plural unspecified any beinoni  	O	null
41 ב ב בספרד preposition unspecified unspecified unspecified unspecified unspecified 0 
41 ספרד ספרד בספרד properName unspecified unspecified unspecified unspecified unspecified  	I_LOC	null
42 אין יש אין existential unspecified unspecified unspecified unspecified unspecified  	O	null
43 גזענות גזענות גזענות noun feminine singular absolute unspecified unspecified  	O	null
44 כי כי כי conjunction unspecified unspecified unspecified unspecified unspecified  	O	null
45 אין יש אין existential unspecified unspecified unspecified unspecified unspecified  	O	null
46 שם שם שם adverb unspecified unspecified unspecified unspecified unspecified  	O	null
47 אשכנזים אשכנזי אשכנזים noun masculine plural absolute unspecified unspecified  	O	null
48 ב ב בטורקיה preposition unspecified unspecified unspecified unspecified unspecified 0 
48 טורקיה טורקיה בטורקיה properName unspecified unspecified unspecified unspecified unspecified  	I_LOC	null
49 אחרי אחרי אחרי preposition unspecified unspecified unspecified unspecified unspecified  	O	null
50 כל כול כל quantifier unspecified unspecified construct unspecified unspecified  	O	null
51 רעש רעש רעש noun masculine singular absolute unspecified unspecified  	O	null
52 בונים בנה בונים verb masculine plural unspecified any beinoni  	O	null
53 בית בית בית noun masculine singular absolute unspecified unspecified  	O	null
54 עם עם עם preposition unspecified unspecified unspecified unspecified unspecified  	O	null
55 גג גג גג noun masculine singular absolute unspecified unspecified  	O	null
56 ב ב באדמה preposition unspecified unspecified unspecified unspecified unspecified 0 
56 אדמה אדמה באדמה noun feminine singular absolute unspecified unspecified  	O	null
57 ב ב באיראן preposition unspecified unspecified unspecified unspecified unspecified 0 
57 איראן איראן באיראן properName unspecified unspecified unspecified unspecified unspecified  	I_LOC	null
58 אגרונומים אגרונום אגרונומים noun masculine plural absolute unspecified unspecified  	O	null
59 מוסלמים מוסלמי מוסלמים adjective masculine plural absolute unspecified unspecified  	O	null
60 מתכננים תכנן מתכננים verb masculine plural unspecified any beinoni  	O	null
61 טיל טיל טיל noun masculine singular absolute unspecified unspecified  	O	null
62 בתוך בתוך בתוך preposition unspecified unspecified unspecified unspecified unspecified  	O	null
63 חממה חממה חממה noun feminine singular absolute unspecified unspecified  	O	null

0 עולם עולם עולם noun masculine singular absolute unspecified unspecified  	O	null
1 מוזר מוזר מוזר adjective masculine singular absolute unspecified unspecified  	O	null
2 לא לא לא negation unspecified unspecified unspecified unspecified unspecified  	O	null
3 נעצר... נעצר... נעצר... participle feminine singular construct any unspecified  	I_ORG	null

0 ב ב בלבנון preposition unspecified unspecified unspecified unspecified unspecified 0 
0 לבנון לבנון בלבנון properName unspecified unspecified unspecified unspecified unspecified  	I_PERS	null
1 בונים בנה בונים verb masculine plural unspecified any beinoni  	O	null
2 שעון שעון שעון noun masculine singular absolute unspecified unspecified  	O	null
3 ה ה המחזיר definiteArticle unspecified unspecified unspecified unspecified unspecified 0 
3 המחזיר החזיר המחזיר participle masculine singular absolute any unspecified  	O	null
4 מ מ מחוגיו preposition unspecified unspecified unspecified unspecified unspecified 0 
4 חוגי חוג מחוגיו noun masculine plural absolute unspecified unspecified  
4 ו ו מחוגיו possessive masculine singular unspecified 3 unspecified 0 	O	null
5 עשר CARD10 עשר numeral feminine singular absolute unspecified unspecified  	O	null
6 שנים שנה שנים noun feminine plural absolute unspecified unspecified  	O	null
7 לאחור לאחור לאחור adverb unspecified unspecified unspecified unspecified unspecified  	O	null
8 ב ב בישראל preposition unspecified unspecified unspecified unspecified unspecified 0 
8 ישראל ישראל בישראל properName unspecified unspecified unspecified unspecified unspecified  	I_LOC	null
9 מייצרים ייצר מייצרים verb masculine plural unspecified any beinoni  	O	null
10 מטוס מטוס מטוס noun masculine singular absolute unspecified unspecified  	O	null
11 זעיר זעיר זעיר adjective masculine singular absolute unspecified unspecified  	O	null
12 ש ש שעובר relativizer/subordinatingConjunction unspecified unspecified unspecified unspecified unspecified 0 
12 עובר עבר שעובר verb masculine singular unspecified any beinoni  	O	null
13 את את את at-preposition unspecified unspecified unspecified unspecified unspecified  	O	null
14 מהירות מהירות מהירות noun feminine singular construct unspecified unspecified  	O	null
15 ה ה האור definiteArticle unspecified unspecified unspecified unspecified unspecified 0 
15 האור אור האור noun masculine singular absolute unspecified unspecified  	O	null
16 ו ו ואצלי conjunction unspecified unspecified unspecified unspecified unspecified 0 
16 אצל אצל ואצלי preposition unspecified unspecified unspecified unspecified unspecified  
16 י י ואצלי pronomial masculine-and-feminine singular unspecified 1 unspecified 0 	O	null
17 על על על preposition unspecified unspecified unspecified unspecified unspecified  	O	null
18 ה ה המקלדת definiteArticle unspecified unspecified unspecified unspecified unspecified 0 
18 המקלדת מקלדת המקלדת noun feminine singular absolute unspecified unspecified  	O	null
19 יש יש יש existential unspecified unspecified unspecified unspecified unspecified  	O	null
20 מנגנון מנגנון מנגנון noun masculine singular absolute unspecified unspecified  	O	null
21 ל ל להשמדת preposition unspecified unspecified unspecified unspecified unspecified 0 
21 השמדת השמדה להשמדת noun feminine singular construct unspecified unspecified  	O	null
22 שירים שיר שירים noun masculine plural absolute unspecified unspecified  	O	null
23 ו ו ומי conjunction unspecified unspecified unspecified unspecified unspecified 0 
23 מי מי ומי interrogative unspecified unspecified unspecified unspecified unspecified  	O	null
24 ש ש שמנגן relativizer/subordinatingConjunction unspecified unspecified unspecified unspecified unspecified 0 
24 מנגן ניגן שמנגן verb masculine singular unspecified any beinoni  	O	null
25 לוקה לקה לוקה verb masculine singular unspecified any beinoni  	O	null
26 ב ב במוחו preposition unspecified unspecified unspecified unspecified unspecified 0 
26 מוח מוח במוחו noun masculine singular absolute unspecified unspecified  
26 ו ו במוחו possessive masculine singular unspecified 3 unspecified 0 	O	null
27 ב ב במחלת preposition unspecified unspecified unspecified unspecified unspecified 0 
27 מחלת מחלה במחלת noun feminine singular construct unspecified unspecified  	O	null
28 ניוון ניוון ניוון noun masculine singular construct unspecified unspecified  	O	null
29 שרירים שריר שרירים noun masculine plural absolute unspecified unspecified  	O	null
30 ו ו ויש conjunction unspecified unspecified unspecified unspecified unspecified 0 
30 יש יש ויש existential unspecified unspecified unspecified unspecified unspecified  	O	null
31 מקש מקש מקש noun masculine singular absolute unspecified unspecified  	O	null
32 אדום אדום אדום adjective masculine singular absolute unspecified unspecified  	O	null
33 ל ל להשמדה preposition unspecified unspecified unspecified unspecified unspecified 0 
33 השמדה השמדה להשמדה noun feminine singular absolute unspecified unspecified  	O	null
34 המונית המוני המונית adjective feminine singular absolute unspecified unspecified  	O	null
35 ה ה המחליט definiteArticle unspecified unspecified unspecified unspecified unspecified 0 
35 המחליט החליט המחליט participle masculine singular absolute any unspecified  	O	null
36 מתי מתי מתי adverb unspecified unspecified unspecified unspecified unspecified  	O	null
37 ללחוץ לחץ ללחוץ verb unspecified unspecified unspecified unspecified infinitive  	O	null
38 על על על preposition unspecified unspecified unspecified unspecified unspecified  	O	null
39 עצמו עצמו עצמו pronoun unspecified unspecified unspecified unspecified unspecified  
39 ו ו עצמו pronomial masculine singular unspecified 3 unspecified 0 	O	null
40 delete delete delete foreign unspecified unspecified unspecified unspecified unspecified  	I_ORG	null

